安徽安凯汽车股份有限公司	安凯客车
宝鼎科技股份有限公司	宝鼎科技
深圳香江控股股份有限公司	香江控股
贵州泰永长征技术股份有限公司	泰永长征
厦门盈趣科技股份有限公司	盈趣科技
重庆秦安机电股份有限公司	秦安股份
江苏凤凰置业投资股份有限公司	凤凰股份
国美通讯设备股份有限公司	国美通讯
深圳市科信通信技术股份有限公司	科信技术
河南神火煤电股份有限公司	神火股份
深圳兆日科技股份有限公司	兆日科技
上海莱士血液制品股份有限公司	上海莱士
恺英网络股份有限公司	恺英网络
东莞市鼎通精密科技股份有限公司	鼎通科技
江苏诺泰澳赛诺生物制药股份有限公司	诺泰生物
哈尔滨哈投投资股份有限公司	哈投股份
江苏雷利电机股份有限公司	江苏雷利
中兴通讯股份有限公司	中兴通讯
深圳英飞拓科技股份有限公司	英飞拓
广州海格通信集团股份有限公司	海格通信
天融信科技集团股份有限公司	天融信
中曼石油天然气集团股份有限公司	中曼石油
亚世光电集团股份有限公司	亚世光电
白银有色集团股份有限公司	白银有色
江苏天奈科技股份有限公司	天奈科技
珠海润都制药股份有限公司	润都股份
广州华研精密机械股份有限公司	华研精机
深圳市联得自动化装备股份有限公司	联得装备
广东骏亚电子科技股份有限公司	骏亚科技
三生国健药业上海股份有限公司	三生国健
济南恒誉环保科技股份有限公司	恒誉环保
中国第一重型机械股份公司	中国一重
广州通达汽车电气股份有限公司	通达电气
深圳市爱施德股份有限公司	爱施德
深圳雷柏科技股份有限公司	雷柏科技
北京北陆药业股份有限公司	北陆药业
万通智控科技股份有限公司	万通智控
长江出版传媒股份有限公司	长江传媒
河北先河环保科技股份有限公司	先河环保
南方电网电力科技股份有限公司	南网科技
上海富瀚微电子股份有限公司	富瀚微
金牌厨柜家居科技股份有限公司	金牌厨柜
湘潭电化科技股份有限公司	湘潭电化
华图山鼎设计股份有限公司	华图山鼎
南京全信传输科技股份有限公司	全信股份
研奥电气股份有限公司	研奥股份
江苏北人智能制造科技股份有限公司	江苏北人
浙江锦盛新材料股份有限公司	锦盛新材
清源科技股份有限公司	清源股份
江苏保千里视像科技集团股份有限公司	保千里
江苏华信新材料股份有限公司	华信新材
北京首创生态环保集团股份有限公司	首创环保
海越能源集团股份有限公司	海越能源
深圳市长盈精密技术股份有限公司	长盈精密
上海润欣科技股份有限公司	润欣科技
浙江兆丰机电股份有限公司	兆丰股份
凯迪生态环境科技股份有限公司	凯迪生态
王力安防科技股份有限公司	王力安防
嘉必优生物技术武汉股份有限公司	嘉必优
浙江中坚科技股份有限公司	中坚科技
四川浩物机电股份有限公司	浩物股份
上海韦尔半导体股份有限公司	韦尔股份
北京赛升药业股份有限公司	赛升药业
宁波建工股份有限公司	宁波建工
湖南恒光科技股份有限公司	恒光股份
软通动力信息技术集团股份有限公司	软通动力
深圳市宝鹰建设控股集团股份有限公司	宝鹰股份
北京百普赛斯生物科技股份有限公司	百普赛斯
天津锐新昌科技股份有限公司	锐新科技
杭州集智机电股份有限公司	集智股份
广东银禧科技股份有限公司	银禧科技
人民网股份有限公司	人民网
内蒙古西水创业股份有限公司	西水股份
浙江交通科技股份有限公司	浙江交科
北京东土科技股份有限公司	东土科技
上海梅林正广和股份有限公司	上海梅林
四川天邑康和通信股份有限公司	天邑股份
青岛港国际股份有限公司	青岛港
北方铜业股份有限公司	北方铜业
哈森商贸中国股份有限公司	哈森股份
广西绿城水务股份有限公司	绿城水务
江苏华绿生物科技股份有限公司	华绿生物
南亚新材料科技股份有限公司	南亚新材
杭州豪悦护理用品股份有限公司	豪悦护理
锦州港股份有限公司	锦州港
嘉和美康北京科技股份有限公司	嘉和美康
苏州世名科技股份有限公司	世名科技
无锡阿科力科技股份有限公司	阿科力
会通新材料股份有限公司	会通股份
京蓝科技股份有限公司	京蓝科技
南凌科技股份有限公司	南凌科技
深圳天源迪科信息技术股份有限公司	天源迪科
恒生电子股份有限公司	恒生电子
北京佳讯飞鸿电气股份有限公司	佳讯飞鸿
威海华东数控股份有限公司	华东数控
焦作万方铝业股份有限公司	焦作万方
浙江巨化股份有限公司	巨化股份
北京中长石基信息技术股份有限公司	石基信息
深圳市显盈科技股份有限公司	显盈科技
浙江润阳新材料科技股份有限公司	润阳科技
浙江瑞晟智能科技股份有限公司	瑞晟智能
合肥丰乐种业股份有限公司	丰乐种业
上海电力股份有限公司	上海电力
新疆国统管道股份有限公司	国统股份
无锡市太极实业股份有限公司	太极实业
淮河能源集团股份有限公司	淮河能源
北京万东医疗科技股份有限公司	万东医疗
珠海光库科技股份有限公司	光库科技
浙江中国小商品城集团股份有限公司	小商品城
杭州可靠护理用品股份有限公司	可靠股份
苏州宝丽迪材料科技股份有限公司	宝丽迪
东浩兰生会展集团股份有限公司	兰生股份
山东奥福环保科技股份有限公司	奥福环保
荣盛石化股份有限公司	荣盛石化
中光学集团股份有限公司	中光学
恒锋信息科技股份有限公司	恒锋信息
厦门吉比特网络技术股份有限公司	吉比特
北京合众思壮科技股份有限公司	合众思壮
宁夏英力特化工股份有限公司	英力特
长航凤凰股份有限公司	长航凤凰
无锡蠡湖增压技术股份有限公司	蠡湖股份
新乡化纤股份有限公司	新乡化纤
三角轮胎股份有限公司	三角轮胎
湖南华纳大药厂股份有限公司	华纳药厂
安徽芯瑞达科技股份有限公司	芯瑞达
中国移动有限公司	中国移动
江西耐普矿机股份有限公司	耐普矿机
湖南九典制药股份有限公司	九典制药
安徽容知日新科技股份有限公司	容知日新
富士康工业互联网股份有限公司	工业富联
天津赛象科技股份有限公司	赛象科技
双乐颜料股份有限公司	双乐股份
绿能慧充数字能源技术股份有限公司	绿能慧充
深圳市三利谱光电科技股份有限公司	三利谱
嘉亨家化股份有限公司	嘉亨家化
湖南天雁机械股份有限公司	湖南天雁
北京大北农科技集团股份有限公司	大北农
浙江海亮股份有限公司	海亮股份
广东雄塑科技集团股份有限公司	雄塑科技
上海海融食品科技股份有限公司	海融科技
华远地产股份有限公司	华远地产
史丹利农业集团股份有限公司	史丹利
浙江海德曼智能装备股份有限公司	浙海德曼
沈阳蓝英工业自动化装备股份有限公司	蓝英装备
江门市科恒实业股份有限公司	科恒股份
四川川大智胜软件股份有限公司	川大智胜
明新旭腾新材料股份有限公司	明新旭腾
深圳市大族数控科技股份有限公司	大族数控
北京安博通科技股份有限公司	安博通
银泰黄金股份有限公司	银泰黄金
云南煤业能源股份有限公司	云煤能源
嘉友国际物流股份有限公司	嘉友国际
浙江日发精密机械股份有限公司	日发精机
上海全筑控股集团股份有限公司	全筑股份
尚纬股份有限公司	尚纬股份
宁波中大力德智能传动股份有限公司	中大力德
广州岭南集团控股股份有限公司	岭南控股
江苏亚邦染料股份有限公司	亚邦股份
龙利得智能科技股份有限公司	龙利得
上海贵酒股份有限公司	岩石股份
广州恒运企业集团股份有限公司	恒运集团
高伟达软件股份有限公司	高伟达
内蒙古伊利实业集团股份有限公司	伊利股份
武汉祥龙电业股份有限公司	祥龙电业
金圆环保股份有限公司	金圆股份
上海三友医疗器械股份有限公司	三友医疗
天津瑞普生物技术股份有限公司	瑞普生物
广东派生智能科技股份有限公司	派生科技
烟台正海磁性材料股份有限公司	正海磁材
深圳市飞荣达科技股份有限公司	飞荣达
唐山冀东装备工程股份有限公司	冀东装备
威胜信息技术股份有限公司	威胜信息
扬州晨化新材料股份有限公司	晨化股份
成都康华生物制品股份有限公司	康华生物
明冠新材料股份有限公司	明冠新材
上海摩恩电气股份有限公司	摩恩电气
浙江富润数字科技股份有限公司	浙江富润
福建龙净环保股份有限公司	龙净环保
广东嘉元科技股份有限公司	嘉元科技
北京捷成世纪科技股份有限公司	捷成股份
拉芳家化股份有限公司	拉芳家化
江苏弘业股份有限公司	弘业股份
上海复旦复华科技股份有限公司	复旦复华
江苏常熟汽饰集团股份有限公司	常熟汽饰
欧菲光集团股份有限公司	欧菲光
三江购物俱乐部股份有限公司	三江购物
国海证券股份有限公司	国海证券
贵人鸟股份有限公司	贵人鸟
广东华锋新能源科技股份有限公司	华锋股份
常州祥明智能动力股份有限公司	祥明智能
江苏纽泰格科技集团股份有限公司	纽泰格
渤海租赁股份有限公司	渤海租赁
宏辉果蔬股份有限公司	宏辉果蔬
北京昭衍新药研究中心股份有限公司	昭衍新药
兰州黄河企业股份有限公司	兰州黄河
江苏联瑞新材料股份有限公司	联瑞新材
上海丽人丽妆化妆品股份有限公司	丽人丽妆
引力传媒股份有限公司	引力传媒
中视传媒股份有限公司	中视传媒
海信视像科技股份有限公司	海信视像
福建火炬电子科技股份有限公司	火炬电子
中原环保股份有限公司	中原环保
宁波柯力传感科技股份有限公司	柯力传感
山西同德化工股份有限公司	同德化工
深圳至正高分子材料股份有限公司	至正股份
胜华新材料集团股份有限公司	胜华新材
河南蓝天燃气股份有限公司	蓝天燃气
上海柘中集团股份有限公司	柘中股份
北京键凯科技股份有限公司	键凯科技
名臣健康用品股份有限公司	名臣健康
云南驰宏锌锗股份有限公司	驰宏锌锗
乐普北京医疗器械股份有限公司	乐普医疗
上海神奇制药投资管理股份有限公司	神奇制药
中化岩土集团股份有限公司	中化岩土
广东宏大控股集团股份有限公司	广东宏大
广东中旗新材料股份有限公司	中旗新材
华林证券股份有限公司	华林证券
合富中国医疗科技股份有限公司	合富中国
江西长运股份有限公司	江西长运
厦门日上集团股份有限公司	日上集团
江苏京源环保股份有限公司	京源环保
郑州千味央厨食品股份有限公司	千味央厨
常州星宇车灯股份有限公司	星宇股份
西藏诺迪康药业股份有限公司	西藏药业
湖南松井新材料股份有限公司	松井股份
北京大豪科技股份有限公司	大豪科技
深圳市雷赛智能控制股份有限公司	雷赛智能
科德数控股份有限公司	科德数控
中航工业机电系统股份有限公司	中航机电
深圳市洲明科技股份有限公司	洲明科技
浙江海翔药业股份有限公司	海翔药业
安克创新科技股份有限公司	安克创新
北京九强生物技术股份有限公司	九强生物
无锡隆盛科技股份有限公司	隆盛科技
华熙生物科技股份有限公司	华熙生物
湖北东贝机电集团股份有限公司	东贝集团
安泰科技股份有限公司	安泰科技
常州匠心独具智能家居股份有限公司	匠心家居
旗天科技集团股份有限公司	旗天科技
利华益维远化学股份有限公司	维远股份
深圳市赢时胜信息技术股份有限公司	赢时胜
三全食品股份有限公司	三全食品
宁波横河精密工业股份有限公司	横河精密
浙江天台祥和实业股份有限公司	祥和实业
山东泰和科技股份有限公司	泰和科技
国泰新点软件股份有限公司	新点软件
江苏图南合金股份有限公司	图南股份
招商局港口集团股份有限公司	招商港口
天津渤海化学股份有限公司	渤海化学
广东华特气体股份有限公司	华特气体
江苏利柏特股份有限公司	利柏特
深圳市奥拓电子股份有限公司	奥拓电子
第一创业证券股份有限公司	第一创业
江西悦安新材料股份有限公司	悦安新材
广东万里马实业股份有限公司	万里马
天音通信控股股份有限公司	天音控股
西安环球印务股份有限公司	环球印务
丹化化工科技股份有限公司	丹化科技
岭南生态文旅股份有限公司	岭南股份
北京北辰实业股份有限公司	北辰实业
江苏南大光电材料股份有限公司	南大光电
重庆市迪马实业股份有限公司	迪马股份
海程邦达供应链管理股份有限公司	海程邦达
方大特钢科技股份有限公司	方大特钢
保定乐凯新材料股份有限公司	乐凯新材
江苏通润装备科技股份有限公司	通润装备
中信出版集团股份有限公司	中信出版
广东科翔电子科技股份有限公司	科翔股份
宁波长鸿高分子科技股份有限公司	长鸿高科
福建凤竹纺织科技股份有限公司	凤竹纺织
迈拓仪表股份有限公司	迈拓股份
深圳劲嘉集团股份有限公司	劲嘉股份
四川和邦生物科技股份有限公司	和邦生物
永艺家具股份有限公司	永艺股份
盈峰环境科技集团股份有限公司	盈峰环境
上海医药集团股份有限公司	上海医药
安徽省皖能股份有限公司	皖能电力
灵康药业集团股份有限公司	灵康药业
深圳市富安娜家居用品股份有限公司	富安娜
广东金马游乐股份有限公司	金马游乐
重庆建设汽车系统股份有限公司	建车B
广东文化长城集团股份有限公司	文化长城
广州酒家集团股份有限公司	广州酒家
安徽省天然气开发股份有限公司	皖天然气
哈药集团人民同泰医药股份有限公司	人民同泰
岳阳林纸股份有限公司	岳阳林纸
美都能源股份有限公司	美都能源
中航光电科技股份有限公司	中航光电
江苏神马电力股份有限公司	神马电力
安徽省通源环境节能股份有限公司	通源环境
慈文传媒股份有限公司	慈文传媒
莱茵达体育发展股份有限公司	莱茵体育
成都彩虹电器集团股份有限公司	彩虹集团
广州瑞松智能科技股份有限公司	瑞松科技
上海水星家用纺织品股份有限公司	水星家纺
无锡派克新材料科技股份有限公司	派克新材
常州澳弘电子股份有限公司	澳弘电子
上海艾力斯医药科技股份有限公司	艾力斯
海航创新股份有限公司	海航创新
南都物业服务集团股份有限公司	南都物业
万华化学集团股份有限公司	万华化学
湖北福星科技股份有限公司	福星股份
上海凯众材料科技股份有限公司	凯众股份
积成电子股份有限公司	积成电子
苏州伟创电气科技股份有限公司	伟创电气
上海华虹计通智能系统股份有限公司	华虹计通
安信信托股份有限公司	安信信托
厦门延江新材料股份有限公司	延江股份
无锡力芯微电子股份有限公司	力芯微
西陇科学股份有限公司	西陇科学
海南大东海旅游中心股份有限公司	大东海
文灿集团股份有限公司	文灿股份
金地集团股份有限公司	金地集团
苏交科集团股份有限公司	苏交科
爱丽家居科技股份有限公司	爱丽家居
普联软件股份有限公司	普联软件
赛摩智能科技集团股份有限公司	赛摩智能
咸亨国际科技股份有限公司	咸亨国际
湖南中科电气股份有限公司	中科电气
海南海药股份有限公司	海南海药
天地源股份有限公司	天地源
华北制药股份有限公司	华北制药
分众传媒信息技术股份有限公司	分众传媒
陕西斯瑞新材料股份有限公司	斯瑞新材
山东博汇纸业股份有限公司	博汇纸业
浙江众成包装材料股份有限公司	浙江众成
深圳市景旺电子股份有限公司	景旺电子
烟台龙源电力技术股份有限公司	龙源技术
苏州富士莱医药股份有限公司	富士莱
兖矿能源集团股份有限公司	兖矿能源
江河创建集团股份有限公司	江河集团
山东高速股份有限公司	山东高速
福建海峡环保集团股份有限公司	海峡环保
安徽铜冠铜箔集团股份有限公司	铜冠铜箔
杭州华旺新材料科技股份有限公司	华旺科技
乐鑫信息科技上海股份有限公司	乐鑫科技
中国电影股份有限公司	中国电影
梦网云科技集团股份有限公司	梦网科技
加加食品集团股份有限公司	加加食品
深圳市远望谷信息技术股份有限公司	远望谷
佛山市国星光电股份有限公司	国星光电
金亚科技股份有限公司	金亚科技
日月重工股份有限公司	日月股份
博士眼镜连锁股份有限公司	博士眼镜
湖南电广传媒股份有限公司	电广传媒
深圳开立生物医疗科技股份有限公司	开立医疗
中冶美利云产业投资股份有限公司	美利云
博天环境集团股份有限公司	博天环境
本钢板材股份有限公司	本钢板材
苏州赛伍应用技术股份有限公司	赛伍技术
芜湖长信科技股份有限公司	长信科技
烟台艾迪精密机械股份有限公司	艾迪精密
中信证券股份有限公司	中信证券
四川安控科技股份有限公司	安控科技
山西仟源医药集团股份有限公司	仟源医药
招商银行股份有限公司	招商银行
重庆市涪陵榨菜集团股份有限公司	涪陵榨菜
广东东阳光科技控股股份有限公司	东阳光
兆易创新科技集团股份有限公司	兆易创新
深圳贝仕达克技术股份有限公司	贝仕达克
安徽鑫铂铝业股份有限公司	鑫铂股份
北京京能热力股份有限公司	京能热力
青岛征和工业股份有限公司	征和工业
上海晨光文具股份有限公司	晨光股份
恒通物流股份有限公司	恒通股份
上海广电电气集团股份有限公司	广电电气
大连晨鑫网络科技股份有限公司	晨鑫科技
迪哲江苏医药股份有限公司	迪哲医药
西部矿业股份有限公司	西部矿业
北京凯文德信教育科技股份有限公司	凯文教育
福建圣农发展股份有限公司	圣农发展
山东新华医疗器械股份有限公司	新华医疗
中孚信息股份有限公司	中孚信息
华润微电子有限公司	华润微
上海同达创业投资股份有限公司	同达创业
深圳市中洲投资控股股份有限公司	中洲控股
荣联科技集团股份有限公司	荣联科技
航天长征化学工程股份有限公司	航天工程
上海大屯能源股份有限公司	上海能源
中捷资源投资股份有限公司	中捷资源
江苏省农垦农业发展股份有限公司	苏垦农发
深圳市艾比森光电股份有限公司	艾比森
深圳中天精装股份有限公司	中天精装
江苏卓易信息科技股份有限公司	卓易信息
北京科拓恒通生物技术股份有限公司	科拓生物
浙江阳光照明电器集团股份有限公司	阳光照明
康泰医学系统秦皇岛股份有限公司	康泰医学
渤海汽车系统股份有限公司	渤海汽车
基蛋生物科技股份有限公司	基蛋生物
利民控股集团股份有限公司	利民股份
广州集泰化工股份有限公司	集泰股份
山东三维化学集团股份有限公司	三维化学
上海润达医疗科技股份有限公司	润达医疗
苏州仕净科技股份有限公司	仕净科技
中铁特货物流股份有限公司	中铁特货
山东玻纤集团股份有限公司	山东玻纤
杭州电缆股份有限公司	杭电股份
阳光电源股份有限公司	阳光电源
北京蓝色光标数据科技股份有限公司	蓝色光标
聚龙股份有限公司	聚龙股份
佳禾智能科技股份有限公司	佳禾智能
嘉事堂药业股份有限公司	嘉事堂
天津友发钢管集团股份有限公司	友发集团
柳州钢铁股份有限公司	柳钢股份
重庆太极实业集团股份有限公司	太极集团
上海睿昂基因科技股份有限公司	睿昂基因
京东方科技集团股份有限公司	京东方
深圳市实益达科技股份有限公司	实益达
德才装饰股份有限公司	德才股份
深圳市佳士科技股份有限公司	佳士科技
江苏沙钢股份有限公司	沙钢股份
泛海控股股份有限公司	泛海控股
江苏省广电有线信息网络股份有限公司	江苏有线
桂林旅游股份有限公司	桂林旅游
河北常山生化药业股份有限公司	常山药业
海欣食品股份有限公司	海欣食品
苏州华兴源创科技股份有限公司	华兴源创
浙江盛洋科技股份有限公司	盛洋科技
深圳市德赛电池科技股份有限公司	德赛电池
山石网科通信技术股份有限公司	山石网科
合肥江航飞机装备股份有限公司	江航装备
福建省青山纸业股份有限公司	青山纸业
广东丸美生物技术股份有限公司	丸美股份
浙农集团股份有限公司	浙农股份
北京恒华伟业科技股份有限公司	恒华科技
万科企业股份有限公司	万科
祖名豆制品股份有限公司	祖名股份
瑞鹄汽车模具股份有限公司	瑞鹄模具
睿智医药科技股份有限公司	睿智医药
重庆建工集团股份有限公司	重庆建工
中国银河证券股份有限公司	中国银河
国药集团药业股份有限公司	国药股份
长春高新技术产业集团股份有限公司	长春高新
瑞斯康达科技发展股份有限公司	瑞斯康达
三盛智慧教育科技股份有限公司	三盛教育
奕东电子科技股份有限公司	奕东电子
江苏德威新材料股份有限公司	德威新材
福建傲农生物科技集团股份有限公司	傲农生物
北京信安世纪科技股份有限公司	信安世纪
内蒙古第一机械集团股份有限公司	内蒙一机
深圳市联赢激光股份有限公司	联赢激光
辽宁科隆精细化工股份有限公司	科隆股份
武汉兴图新科电子股份有限公司	兴图新科
湖南南岭民用爆破器材股份有限公司	南岭民爆
武汉高德红外股份有限公司	高德红外
荣丰控股集团股份有限公司	荣丰控股
江苏宁沪高速公路股份有限公司	宁沪高速
腾景科技股份有限公司	腾景科技
北京万邦达环保技术股份有限公司	万邦达
中国船舶重工集团动力股份有限公司	中国动力
天津创业环保集团股份有限公司	创业环保
富春科技股份有限公司	富春股份
浙江威星智能仪表股份有限公司	威星智能
杭州禾迈电力电子股份有限公司	禾迈股份
天津普林电路股份有限公司	天津普林
浙江仙琚制药股份有限公司	仙琚制药
河南平高电气股份有限公司	平高电气
茂名石化实华股份有限公司	茂化实华
江苏华盛天龙光电设备股份有限公司	天龙光电
厦门建发股份有限公司	建发股份
优利德科技中国股份有限公司	优利德
上海紫江企业集团股份有限公司	紫江企业
上海市北高新股份有限公司	市北高新
中储发展股份有限公司	中储股份
奥特佳新能源科技股份有限公司	奥特佳
重庆顺博铝合金股份有限公司	顺博合金
哈尔滨九洲集团股份有限公司	九洲集团
贵州益佰制药股份有限公司	益佰制药
常州腾龙汽车零部件股份有限公司	腾龙股份
北矿科技股份有限公司	北矿科技
诚志股份有限公司	诚志股份
苏州天准科技股份有限公司	天准科技
重药控股股份有限公司	重药控股
方正科技集团股份有限公司	方正科技
云南神农农业产业集团股份有限公司	神农集团
杭州银行股份有限公司	杭州银行
浙江春风动力股份有限公司	春风动力
广东红墙新材料股份有限公司	红墙股份
红星美凯龙家居集团股份有限公司	美凯龙
湖南泰嘉新材料科技股份有限公司	泰嘉股份
浙江百达精工股份有限公司	百达精工
朗姿股份有限公司	朗姿股份
哈尔滨工大高新技术产业开发股份有限公司	工大高新
厦门象屿股份有限公司	厦门象屿
上海克来机电自动化工程股份有限公司	克来机电
深圳市海王生物工程股份有限公司	海王生物
无锡德林海环保科技股份有限公司	德林海
赛力斯集团股份有限公司	赛力斯
陕西北元化工集团股份有限公司	北元集团
广东燕塘乳业股份有限公司	燕塘乳业
宁波海天精工股份有限公司	海天精工
华油惠博普科技股份有限公司	惠博普
国网信息通信股份有限公司	国网信通
河南黄河旋风股份有限公司	黄河旋风
中山联合光电科技股份有限公司	联合光电
中航西安飞机工业集团股份有限公司	中航西飞
河南新宁现代物流股份有限公司	新宁物流
北京金一文化发展股份有限公司	金一文化
北京京西文化旅游股份有限公司	北京文化
普元信息技术股份有限公司	普元信息
五洲特种纸业集团股份有限公司	五洲特纸
山东豪迈机械科技股份有限公司	豪迈科技
江阴标榜汽车部件股份有限公司	标榜股份
西藏卫信康医药股份有限公司	卫信康
广州鹿山新材料股份有限公司	鹿山新材
河南四方达超硬材料股份有限公司	四方达
浙江伟星新型建材股份有限公司	伟星新材
山东新华制药股份有限公司	新华制药
依米康科技集团股份有限公司	依米康
广东长青集团股份有限公司	长青集团
上海大名城企业股份有限公司	大名城
双良节能系统股份有限公司	双良节能
海南京粮控股股份有限公司	京粮控股
重庆三峡油漆股份有限公司	渝三峡
五矿发展股份有限公司	五矿发展
江苏国茂减速机股份有限公司	国茂股份
广东东鹏控股股份有限公司	东鹏控股
拓尔思信息技术股份有限公司	拓尔思
深圳市蕾奥规划设计咨询股份有限公司	蕾奥规划
北京巴士传媒股份有限公司	北巴传媒
中国中煤能源股份有限公司	中煤能源
隆华科技集团洛阳股份有限公司	隆华科技
科美诊断技术股份有限公司	科美诊断
上海创兴资源开发股份有限公司	创兴资源
中远海运能源运输股份有限公司	中远海能
桐昆集团股份有限公司	桐昆股份
上海华培动力科技集团股份有限公司	华培动力
汉宇集团股份有限公司	汉宇集团
株洲冶炼集团股份有限公司	株冶集团
江苏蔚蓝锂芯股份有限公司	蔚蓝锂芯
广州尚品宅配家居股份有限公司	尚品宅配
河南翔宇医疗设备股份有限公司	翔宇医疗
张家港保税科技集团股份有限公司	保税科技
江苏常宝钢管股份有限公司	常宝股份
青岛威奥轨道股份有限公司	威奥股份
深圳市银宝山新科技股份有限公司	银宝山新
江苏扬电科技股份有限公司	扬电科技
广东绿岛风空气系统股份有限公司	绿岛风
长发集团长江投资实业股份有限公司	长江投资
浙江捷昌线性驱动科技股份有限公司	捷昌驱动
华映科技集团股份有限公司	华映科技
鹏鹞环保股份有限公司	鹏鹞环保
广东蒙泰高新纤维股份有限公司	蒙泰高新
湖南友谊阿波罗商业股份有限公司	友阿股份
深圳市迅捷兴科技股份有限公司	迅捷兴
中国邮政储蓄银行股份有限公司	邮储银行
浙江维康药业股份有限公司	维康药业
上海锦江国际旅游股份有限公司	锦旅股份
山东黄金矿业股份有限公司	山东黄金
亚振家居股份有限公司	亚振家居
中科星图股份有限公司	中科星图
上海盛剑环境系统科技股份有限公司	盛剑环境
中国建筑股份有限公司	中国建筑
河南思维自动化设备股份有限公司	思维列控
中汽研汽车试验场股份有限公司	中汽股份
青岛银行股份有限公司	青岛银行
中山公用事业集团股份有限公司	中山公用
广东肇庆星湖生物科技股份有限公司	星湖科技
山西杏花村汾酒厂股份有限公司	山西汾酒
金杯电工股份有限公司	金杯电工
上海晶华胶粘新材料股份有限公司	晶华新材
株洲天桥起重机股份有限公司	天桥起重
广州毅昌科技股份有限公司	毅昌科技
中材科技股份有限公司	中材科技
江苏雅克科技股份有限公司	雅克科技
重庆百亚卫生用品股份有限公司	百亚股份
隆鑫通用动力股份有限公司	隆鑫通用
聚灿光电科技股份有限公司	聚灿光电
上海徕木电子股份有限公司	徕木股份
长城证券股份有限公司	长城证券
协鑫能源科技股份有限公司	协鑫能科
北京浩丰创源科技股份有限公司	浩丰科技
浙江华铁应急设备科技股份有限公司	华铁应急
河南金丹乳酸科技股份有限公司	金丹科技
湖北三峡新型建材股份有限公司	三峡新材
上海国际港务集团股份有限公司	上港集团
华丰动力股份有限公司	华丰股份
中国交通建设股份有限公司	中国交建
天海融合防务装备技术股份有限公司	天海防务
江苏双星彩塑新材料股份有限公司	双星新材
平安银行股份有限公司	平安银行
黑龙江出版传媒股份有限公司	龙版传媒
佛山市海天调味食品股份有限公司	海天味业
深圳市金新农科技股份有限公司	金新农
安徽九华山旅游发展股份有限公司	九华旅游
浙江永太科技股份有限公司	永太科技
包头明天科技股份有限公司	明天科技
维信诺科技股份有限公司	维信诺
安徽德豪润达电气股份有限公司	德豪润达
北京首商集团股份有限公司	首商股份
北汽福田汽车股份有限公司	福田汽车
国机汽车股份有限公司	国机汽车
江苏金迪克生物技术股份有限公司	金迪克
中伟新材料股份有限公司	中伟股份
东莞市奥海科技股份有限公司	奥海科技
博彦科技股份有限公司	博彦科技
恒为科技上海股份有限公司	恒为科技
武汉回盛生物科技股份有限公司	回盛生物
广东坚朗五金制品股份有限公司	坚朗五金
深圳市蓝海华腾技术股份有限公司	蓝海华腾
科大国创软件股份有限公司	科大国创
莱绅通灵珠宝股份有限公司	莱绅通灵
山东百龙创园生物科技股份有限公司	百龙创园
安徽国风新材料股份有限公司	国风新材
北京青云科技股份有限公司	青云科技
杭州雷迪克节能科技股份有限公司	雷迪克
湖南梦洁家纺股份有限公司	梦洁股份
杭州奥泰生物技术股份有限公司	奥泰生物
珠海高凌信息科技股份有限公司	高凌信息
华融化学股份有限公司	华融化学
宁波弘讯科技股份有限公司	弘讯科技
成都欧林生物科技股份有限公司	欧林生物
广东宝莱特医用科技股份有限公司	宝莱特
广州金逸影视传媒股份有限公司	金逸影视
山东华鹏玻璃股份有限公司	山东华鹏
广东新会美达锦纶股份有限公司	美达股份
北京世纪瑞尔技术股份有限公司	世纪瑞尔
浙江荣晟环保纸业股份有限公司	荣晟环保
广西粤桂广业控股股份有限公司	粤桂股份
广州普邦园林股份有限公司	普邦股份
华电国际电力股份有限公司	华电国际
南京红太阳股份有限公司	红太阳
南威软件股份有限公司	南威软件
华辰精密装备昆山股份有限公司	华辰装备
新大陆数字技术股份有限公司	新大陆
上海太和水科技发展股份有限公司	太和水
楚天科技股份有限公司	楚天科技
奥瑞金科技股份有限公司	奥瑞金
北京辰安科技股份有限公司	辰安科技
上海赛伦生物技术股份有限公司	赛伦生物
北京东方雨虹防水技术股份有限公司	东方雨虹
成都市新筑路桥机械股份有限公司	新筑股份
山东日科化学股份有限公司	日科化学
西部证券股份有限公司	西部证券
北京东方中科集成科技股份有限公司	东方中科
泰晶科技股份有限公司	泰晶科技
吉林化纤股份有限公司	吉林化纤
浙江钱江摩托股份有限公司	钱江摩托
上海天永智能装备股份有限公司	天永智能
杭州士兰微电子股份有限公司	士兰微
香溢融通控股集团股份有限公司	香溢融通
香农芯创科技股份有限公司	香农芯创
广东领益智造股份有限公司	领益智造
浙江本立科技股份有限公司	本立科技
中国广核电力股份有限公司	中国广核
海澜之家集团股份有限公司	海澜之家
上海申达股份有限公司	申达股份
浙江佐力药业股份有限公司	佐力药业
北京久其软件股份有限公司	久其软件
南侨食品集团上海股份有限公司	南侨食品
洛阳栾川钼业集团股份有限公司	洛阳钼业
厦门中创环保科技股份有限公司	中创环保
杭州微光电子股份有限公司	微光股份
广州迪森热能技术股份有限公司	迪森股份
崇达技术股份有限公司	崇达技术
华锐风电科技集团股份有限公司	华锐风电
江苏鱼跃医疗设备股份有限公司	鱼跃医疗
九江善水科技股份有限公司	善水科技
江西金达莱环保股份有限公司	金达莱
北京昊华能源股份有限公司	昊华能源
中华企业股份有限公司	中华企业
宏昌电子材料股份有限公司	宏昌电子
山东鲁北化工股份有限公司	鲁北化工
深圳信测标准技术服务股份有限公司	信测标准
华峰化学股份有限公司	华峰化学
上海凤凰企业集团股份有限公司	上海凤凰
合肥立方制药股份有限公司	立方制药
神州高铁技术股份有限公司	神州高铁
平顶山天安煤业股份有限公司	平煤股份
深圳奥特迅电力设备股份有限公司	奥特迅
深圳市智动力精密技术股份有限公司	智动力
重庆再升科技股份有限公司	再升科技
海默科技集团股份有限公司	海默科技
汕头东风印刷股份有限公司	东风股份
北京光线传媒股份有限公司	光线传媒
通源石油科技集团股份有限公司	通源石油
江苏晶雪节能科技股份有限公司	晶雪节能
许昌远东传动轴股份有限公司	远东传动
三友联众集团股份有限公司	三友联众
广东安居宝数码科技股份有限公司	安居宝
山大地纬软件股份有限公司	山大地纬
百奥泰生物制药股份有限公司	百奥泰
西部黄金股份有限公司	西部黄金
深圳市捷佳伟创新能源装备股份有限公司	捷佳伟创
返利网数字科技股份有限公司	返利科技
青岛达能环保设备股份有限公司	青达环保
江苏春兰制冷设备股份有限公司	春兰股份
中国长江电力股份有限公司	长江电力
烟台杰瑞石油服务集团股份有限公司	杰瑞股份
海南金盘智能科技股份有限公司	金盘科技
正元地理信息集团股份有限公司	正元地信
欢乐家食品集团股份有限公司	欢乐家
深圳洪涛集团股份有限公司	洪涛股份
深圳市裕同包装科技股份有限公司	裕同科技
汇纳科技股份有限公司	汇纳科技
佳通轮胎股份有限公司	佳通轮胎
万邦德医药控股集团股份有限公司	万邦德
中远海运控股股份有限公司	中远海控
深圳市中新赛克科技股份有限公司	中新赛克
万达信息股份有限公司	万达信息
杭州海康威视数字技术股份有限公司	海康威视
南京冠石科技股份有限公司	冠石科技
秦川机床工具集团股份公司	秦川机床
启迪环境科技发展股份有限公司	启迪环境
浙江五洲新春集团股份有限公司	五洲新春
合肥芯碁微电子装备股份有限公司	芯碁微装
龙元建设集团股份有限公司	龙元建设
云南恩捷新材料股份有限公司	恩捷股份
安徽省交通规划设计研究总院股份有限公司	设计总院
安徽铜峰电子股份有限公司	铜峰电子
中粮生物科技股份有限公司	中粮科技
杭州中恒电气股份有限公司	中恒电气
凯盛新能源股份有限公司	凯盛新能
天津长荣科技集团股份有限公司	长荣股份
上海君实生物医药科技股份有限公司	君实生物
成都红旗连锁股份有限公司	红旗连锁
武汉理工光科股份有限公司	理工光科
创新医疗管理股份有限公司	创新医疗
广东顺控发展股份有限公司	顺控发展
江苏中捷精工科技股份有限公司	中捷精工
云鼎科技股份有限公司	云鼎科技
中体产业集团股份有限公司	中体产业
四川金石亚洲医药股份有限公司	金石亚药
北新集团建材股份有限公司	北新建材
山东联创产业发展集团股份有限公司	联创股份
伊戈尔电气股份有限公司	伊戈尔
陕西兴化化学股份有限公司	兴化股份
冰山冷热科技股份有限公司	冰山冷热
内蒙古电投能源股份有限公司	电投能源
高斯贝尔数码科技股份有限公司	高斯贝尔
珠海欧比特宇航科技股份有限公司	欧比特
中兴天恒能源科技北京股份公司	中天能源
锦泓时装集团股份有限公司	锦泓集团
陕西广电网络传媒集团股份有限公司	广电网络
上海汽车集团股份有限公司	上汽集团
神通科技集团股份有限公司	神通科技
银邦金属复合材料股份有限公司	银邦股份
青岛汉缆股份有限公司	汉缆股份
韵达控股股份有限公司	韵达股份
长江润发健康产业股份有限公司	长江健康
江苏南方卫材医药股份有限公司	南卫股份
太原重工股份有限公司	太原重工
博通集成电路上海股份有限公司	博通集成
宁波家联科技股份有限公司	家联科技
四川科伦药业股份有限公司	科伦药业
赛隆药业集团股份有限公司	赛隆药业
中亿丰罗普斯金材料科技股份有限公司	罗普斯金
安徽华茂纺织股份有限公司	华茂股份
湖北盛天网络技术股份有限公司	盛天网络
新华都科技股份有限公司	新华都
北京中石伟业科技股份有限公司	中石科技
福建赛特新材股份有限公司	赛特新材
杭州壹网壹创科技股份有限公司	壹网壹创
广东惠伦晶体科技股份有限公司	惠伦晶体
浙江卓锦环保科技股份有限公司	卓锦股份
东莞铭普光磁股份有限公司	铭普光磁
天津卓朗信息科技股份有限公司	卓朗科技
广东新劲刚科技股份有限公司	新劲刚
浙江米奥兰特商务会展股份有限公司	米奥会展
深圳市美芝装饰设计工程股份有限公司	美芝股份
怡球金属资源再生中国股份有限公司	怡球资源
有友食品股份有限公司	有友食品
北京空港科技园区股份有限公司	空港股份
大秦铁路股份有限公司	大秦铁路
山西华翔集团股份有限公司	华翔股份
镇海石化工程股份有限公司	镇海股份
万马科技股份有限公司	万马科技
江苏恒瑞医药股份有限公司	恒瑞医药
康达新材料集团股份有限公司	康达新材
山河智能装备股份有限公司	山河智能
浙江康盛股份有限公司	康盛股份
福建榕基软件股份有限公司	榕基软件
浙江亚厦装饰股份有限公司	亚厦股份
江苏天目湖旅游股份有限公司	天目湖
乐凯胶片股份有限公司	乐凯胶片
佛山佛塑科技集团股份有限公司	佛塑科技
秦皇岛天秦装备制造股份有限公司	天秦装备
贵州红星发展股份有限公司	红星发展
浙江中胤时尚股份有限公司	中胤时尚
上海霍普建筑设计事务所股份有限公司	霍普股份
东华工程科技股份有限公司	东华科技
烟台园城黄金股份有限公司	园城黄金
青岛啤酒股份有限公司	青岛啤酒
安徽众源新材料股份有限公司	众源新材
上海步科自动化股份有限公司	步科股份
中珠医疗控股股份有限公司	中珠医疗
浙江双环传动机械股份有限公司	双环传动
学大厦门教育科技集团股份有限公司	学大教育
德州联合石油科技股份有限公司	德石股份
浙江华友钴业股份有限公司	华友钴业
杭州电魂网络科技股份有限公司	电魂网络
宁波双林汽车部件股份有限公司	双林股份
北京当升材料科技股份有限公司	当升科技
山西兰花科技创业股份有限公司	兰花科创
深圳雷曼光电科技股份有限公司	雷曼光电
华东建筑集团股份有限公司	华建集团
天津富通信息科技股份有限公司	富通信息
西部金属材料股份有限公司	西部材料
天山铝业集团股份有限公司	天山铝业
浙江泰福泵业股份有限公司	泰福泵业
北京富吉瑞光电科技股份有限公司	富吉瑞
中金黄金股份有限公司	中金黄金
江苏博迁新材料股份有限公司	博迁新材
青海盐湖工业股份有限公司	盐湖股份
北京必创科技股份有限公司	必创科技
湖北武昌鱼股份有限公司	武昌鱼
上海微创心脉医疗科技集团股份有限公司	心脉医疗
华孚时尚股份有限公司	华孚时尚
襄阳博亚精工装备股份有限公司	博亚精工
上海富控互动娱乐股份有限公司	富控互动
晶科电力科技股份有限公司	晶科科技
上海百联集团股份有限公司	百联股份
万达电影股份有限公司	万达电影
福建三钢闽光股份有限公司	三钢闽光
中煤新集能源股份有限公司	新集能源
中嘉博创信息技术股份有限公司	中嘉博创
中国石油集团工程股份有限公司	中油工程
宁波创源文化发展股份有限公司	创源股份
山东力诺特种玻璃股份有限公司	力诺特玻
深圳市锐明技术股份有限公司	锐明技术
山东新北洋信息技术股份有限公司	新北洋
厦门瑞尔特卫浴科技股份有限公司	瑞尔特
武汉力源信息技术股份有限公司	力源信息
比亚迪股份有限公司	比亚迪
报喜鸟控股股份有限公司	报喜鸟
宁波世茂能源股份有限公司	世茂能源
广东泉为科技股份有限公司	泉为科技
重庆丰华集团股份有限公司	丰华股份
四川成飞集成科技股份有限公司	成飞集成
通策医疗股份有限公司	通策医疗
天津凯发电气股份有限公司	凯发电气
贵州燃气集团股份有限公司	贵州燃气
精华制药集团股份有限公司	精华制药
上海龙韵文创科技集团股份有限公司	龙韵股份
中百控股集团股份有限公司	中百集团
四川中光防雷科技股份有限公司	中光防雷
广东天安新材料股份有限公司	天安新材
苏州胜利精密制造科技股份有限公司	胜利精密
湖南科创信息技术股份有限公司	科创信息
深圳市新星轻合金材料股份有限公司	深圳新星
广州航新航空科技股份有限公司	航新科技
江苏爱康科技股份有限公司	爱康科技
山东美晨生态环境股份有限公司	美晨生态
上海海优威新材料股份有限公司	海优新材
贵州航天电器股份有限公司	航天电器
杭州万事利丝绸文化股份有限公司	万事利
浙江天成自控股份有限公司	天成自控
江西晨光新材料股份有限公司	晨光新材
快克智能装备股份有限公司	快克智能
深圳市三旺通信股份有限公司	三旺通信
山西焦化股份有限公司	山西焦化
深圳市创益通技术股份有限公司	创益通
科沃斯机器人股份有限公司	科沃斯
九阳股份有限公司	九阳股份
恒天凯马股份有限公司	凯马股份
北京华峰测控技术股份有限公司	华峰测控
安徽合力股份有限公司	安徽合力
珠海中富实业股份有限公司	珠海中富
索通发展股份有限公司	索通发展
安道麦股份有限公司	安道麦
北京金隅集团股份有限公司	金隅集团
深圳清溢光电股份有限公司	清溢光电
昊华化工科技集团股份有限公司	昊华科技
洛阳北方玻璃技术股份有限公司	北玻股份
烟台正海生物科技股份有限公司	正海生物
北京神州泰岳软件股份有限公司	神州泰岳
深圳市劲拓自动化设备股份有限公司	劲拓股份
宁波江丰电子材料股份有限公司	江丰电子
贵州长征天成控股股份有限公司	天成控股
北京三维天地科技股份有限公司	三维天地
无锡奥特维科技股份有限公司	奥特维
宁波美诺华药业股份有限公司	美诺华
湖北国创高新材料股份有限公司	国创高新
陕西省国际信托股份有限公司	陕国投
银川新华百货商业集团股份有限公司	新华百货
佳都科技集团股份有限公司	佳都科技
杭华油墨股份有限公司	杭华股份
康力电梯股份有限公司	康力电梯
苏州安洁科技股份有限公司	安洁科技
安徽安利材料科技股份有限公司	安利股份
中国银行股份有限公司	中国银行
厦门法拉电子股份有限公司	法拉电子
深圳市欣天科技股份有限公司	欣天科技
北京淳中科技股份有限公司	淳中科技
深圳爱克莱特科技股份有限公司	爱克股份
北方光电股份有限公司	光电股份
保定天威保变电气股份有限公司	保变电气
中国冶金科工股份有限公司	中国中冶
上海海利生物技术股份有限公司	海利生物
江苏华宏科技股份有限公司	华宏科技
南通超达装备股份有限公司	超达装备
上海艾为电子技术股份有限公司	艾为电子
宁波博汇化工科技股份有限公司	博汇股份
洛阳建龙微纳新材料股份有限公司	建龙微纳
大庆华科股份有限公司	大庆华科
深圳市燕麦科技股份有限公司	燕麦科技
唐山三友化工股份有限公司	三友化工
彤程新材料集团股份有限公司	彤程新材
深南电路股份有限公司	深南电路
株洲中车时代电气股份有限公司	时代电气
河南明泰铝业股份有限公司	明泰铝业
吉林奥来德光电材料股份有限公司	奥来德
杭州福斯特应用材料股份有限公司	福斯特
北京千方科技股份有限公司	千方科技
烽火通信科技股份有限公司	烽火通信
浙江宏昌电器科技股份有限公司	宏昌科技
深圳市卓翼科技股份有限公司	卓翼科技
苏州科德教育科技股份有限公司	科德教育
洲际油气股份有限公司	洲际油气
西安炬光科技股份有限公司	炬光科技
三维控股集团股份有限公司	三维股份
康美药业股份有限公司	康美药业
安徽鸿路钢结构集团股份有限公司	鸿路钢构
广西梧州中恒集团股份有限公司	中恒集团
绿盟科技集团股份有限公司	绿盟科技
浙江黎明智造股份有限公司	浙江黎明
深圳明阳电路科技股份有限公司	明阳电路
中昌大数据股份有限公司	中昌数据
北京百华悦邦科技股份有限公司	百邦科技
太极计算机股份有限公司	太极股份
深圳市翔丰华科技股份有限公司	翔丰华
爱慕股份有限公司	爱慕股份
万泽实业股份有限公司	万泽股份
宁波容百新能源科技股份有限公司	容百科技
山东恒邦冶炼股份有限公司	恒邦股份
浙江唐德影视股份有限公司	唐德影视
深圳市亚辉龙生物科技股份有限公司	亚辉龙
合肥泰禾智能科技集团股份有限公司	泰禾智能
中富通集团股份有限公司	中富通
三安光电股份有限公司	三安光电
广东三雄极光照明股份有限公司	三雄极光
中电科数字技术股份有限公司	电科数字
甘肃莫高实业发展股份有限公司	莫高股份
中国稀土集团资源科技股份有限公司	中国稀土
深圳丹邦科技股份有限公司	丹邦科技
新开普电子股份有限公司	新开普
上海顺灏新材料科技股份有限公司	顺灏股份
苏州恒久光电科技股份有限公司	恒久科技
永清环保股份有限公司	永清环保
广州金域医学检验集团股份有限公司	金域医学
道明光学股份有限公司	道明光学
常州中英科技股份有限公司	中英科技
当代东方投资股份有限公司	当代东方
泰豪科技股份有限公司	泰豪科技
山东三元生物科技股份有限公司	三元生物
苏州固锝电子股份有限公司	苏州固锝
江西国光商业连锁股份有限公司	国光连锁
江苏久吾高科技股份有限公司	久吾高科
广东因赛品牌营销集团股份有限公司	因赛集团
中能电气股份有限公司	中能电气
深圳信立泰药业股份有限公司	信立泰
中航沈飞股份有限公司	中航沈飞
无锡威孚高科技集团股份有限公司	威孚高科
上海安诺其集团股份有限公司	安诺其
曲美家居集团股份有限公司	曲美家居
宁波杉杉股份有限公司	杉杉股份
湛江国联水产开发股份有限公司	国联水产
文投控股股份有限公司	文投控股
思瑞浦微电子科技苏州股份有限公司	思瑞浦
中建西部建设股份有限公司	西部建设
海伦钢琴股份有限公司	海伦钢琴
花王生态工程股份有限公司	花王股份
财达证券股份有限公司	财达证券
中电电机股份有限公司	中电电机
深圳市中金岭南有色金属股份有限公司	中金岭南
广东聚石化学股份有限公司	聚石化学
冀凯装备制造股份有限公司	冀凯股份
天津久日新材料股份有限公司	久日新材
南京奥联汽车电子电器股份有限公司	奥联电子
杭州滨江房产集团股份有限公司	滨江集团
浙江英特集团股份有限公司	英特集团
重庆涪陵电力实业股份有限公司	涪陵电力
上海嘉麟杰纺织品股份有限公司	嘉麟杰
北京声迅电子股份有限公司	声迅股份
中国建设银行股份有限公司	建设银行
北京沃尔德金刚石工具股份有限公司	沃尔德
晨光生物科技集团股份有限公司	晨光生物
上海张江高科技园区开发股份有限公司	张江高科
山西省国新能源股份有限公司	国新能源
上海至纯洁净系统科技股份有限公司	至纯科技
云南南天电子信息产业股份有限公司	南天信息
浙江伟星实业发展股份有限公司	伟星股份
安记食品股份有限公司	安记食品
广东甘化科工股份有限公司	甘化科工
中文天地出版传媒集团股份有限公司	中文传媒
巨人网络集团股份有限公司	巨人网络
深圳市全新好股份有限公司	全新好
天津市房地产发展集团股份有限公司	天房发展
深圳同兴达科技股份有限公司	同兴达
江苏凤凰出版传媒股份有限公司	凤凰传媒
新疆东方环宇燃气股份有限公司	东方环宇
台海玛努尔核电设备股份有限公司	台海核电
内蒙古远兴能源股份有限公司	远兴能源
苏州道森钻采设备股份有限公司	道森股份
步步高商业连锁股份有限公司	步步高
三维通信股份有限公司	三维通信
海联金汇科技股份有限公司	海联金汇
山东南山智尚科技股份有限公司	南山智尚
茶花现代家居用品股份有限公司	茶花股份
优彩环保资源科技股份有限公司	优彩资源
长城汽车股份有限公司	长城汽车
北京宝兰德软件股份有限公司	宝兰德
华仪电气股份有限公司	华仪电气
浙江建业化工股份有限公司	建业股份
克劳斯玛菲股份有限公司	克劳斯
沈阳金山能源股份有限公司	金山股份
东方证券股份有限公司	东方证券
安徽新力金融股份有限公司	新力金融
森林包装集团股份有限公司	森林包装
瑞达期货股份有限公司	瑞达期货
无锡新宏泰电器科技股份有限公司	新宏泰
北京北斗星通导航技术股份有限公司	北斗星通
深圳市盛弘电气股份有限公司	盛弘股份
厦门弘信电子科技集团股份有限公司	弘信电子
浙江杭可科技股份有限公司	杭可科技
福建福光股份有限公司	福光股份
四川川投能源股份有限公司	川投能源
北京翠微大厦股份有限公司	翠微股份
安徽金种子酒业股份有限公司	金种子酒
深圳市北鼎晶辉科技股份有限公司	北鼎股份
宁波兴瑞电子科技股份有限公司	兴瑞科技
东方国际创业股份有限公司	东方创业
大亚圣象家居股份有限公司	大亚圣象
福建七匹狼实业股份有限公司	七匹狼
深圳市力合科创股份有限公司	力合科创
山东新能泰山发电股份有限公司	新能泰山
昇兴集团股份有限公司	升兴股份
上海移为通信技术股份有限公司	移为通信
闻泰科技股份有限公司	闻泰科技
汇绿生态科技集团股份有限公司	汇绿生态
恒天海龙股份有限公司	恒天海龙
贵州信邦制药股份有限公司	信邦制药
丽珠医药集团股份有限公司	丽珠集团
广东天禾农资股份有限公司	天禾股份
山西证券股份有限公司	山西证券
新疆百花村医药集团股份有限公司	百花医药
郑州煤电股份有限公司	郑州煤电
大千生态环境集团股份有限公司	大千生态
蒙娜丽莎集团股份有限公司	蒙娜丽莎
深圳市奋达科技股份有限公司	奋达科技
中铁铁龙集装箱物流股份有限公司	铁龙物流
中核华原钛白股份有限公司	中核钛白
厦门市美亚柏科信息股份有限公司	美亚柏科
中航电测仪器股份有限公司	中航电测
浙江绍兴瑞丰农村商业银行股份有限公司	瑞丰银行
山东省中鲁远洋渔业股份有限公司	中鲁远洋
云南云维股份有限公司	云维股份
阿尔特汽车技术股份有限公司	阿尔特
三只松鼠股份有限公司	三只松鼠
广东梅雁吉祥水电股份有限公司	梅雁吉祥
江苏宝利国际投资股份有限公司	宝利国际
瀚蓝环境股份有限公司	瀚蓝环境
广西桂冠电力股份有限公司	桂冠电力
东瑞食品集团股份有限公司	东瑞股份
北部湾港股份有限公司	北部湾港
派斯林数字科技股份有限公司	派斯林
运盛成都医疗科技股份有限公司	运盛医疗
山东龙力生物科技股份有限公司	龙力生物
深圳瑞和建筑装饰股份有限公司	瑞和股份
新疆伊力特实业股份有限公司	伊力特
中国汽车工程研究院股份有限公司	中国汽研
湖南丽臣实业股份有限公司	丽臣实业
福建南平太阳电缆股份有限公司	太阳电缆
湖南千山制药机械股份有限公司	千山药机
深圳奥尼电子股份有限公司	奥尼电子
览海医疗产业投资股份有限公司	览海医疗
中天服务股份有限公司	中天服务
澳柯玛股份有限公司	澳柯玛
深圳新益昌科技股份有限公司	新益昌
恒银金融科技股份有限公司	恒银科技
哈尔滨秋林集团股份有限公司	秋林集团
福建省永安林业集团股份有限公司	永安林业
盛德鑫泰新材料股份有限公司	盛德鑫泰
上海家化联合股份有限公司	上海家化
春雪食品集团股份有限公司	春雪食品
武汉中科通达高新技术股份有限公司	中科通达
杭州泰格医药科技股份有限公司	泰格医药
新疆交通建设集团股份有限公司	新疆交建
上海健麾信息技术股份有限公司	健麾信息
银都餐饮设备股份有限公司	银都股份
中粮科工股份有限公司	中粮科工
杭州前进齿轮箱集团股份有限公司	杭齿前进
山东登海种业股份有限公司	登海种业
熊猫金控股份有限公司	熊猫金控
江苏东华测试技术股份有限公司	东华测试
深圳市财富趋势科技股份有限公司	财富趋势
乐山巨星农牧股份有限公司	巨星农牧
湖南宇晶机器股份有限公司	宇晶股份
福能东方装备科技股份有限公司	福能东方
浙江明牌珠宝股份有限公司	明牌珠宝
上海华峰铝业股份有限公司	华峰铝业
上海同济科技实业股份有限公司	同济科技
烟台东诚药业集团股份有限公司	东诚药业
广州禾信仪器股份有限公司	禾信仪器
杰创智能科技股份有限公司	杰创智能
苏文电能科技股份有限公司	苏文电能
旺能环境股份有限公司	旺能环境
广东水电二局股份有限公司	粤水电
山东玉马遮阳科技股份有限公司	玉马遮阳
北大医药股份有限公司	北大医药
福建青松股份有限公司	青松股份
上海龙宇数据股份有限公司	龙宇股份
山西通宝能源股份有限公司	通宝能源
振德医疗用品股份有限公司	振德医疗
桃李面包股份有限公司	桃李面包
成都云图控股股份有限公司	云图控股
湖南长远锂科股份有限公司	长远锂科
奥维通信股份有限公司	奥维通信
中信银行股份有限公司	中信银行
黑龙江北大荒农业股份有限公司	北大荒
华凯易佰科技股份有限公司	华凯易佰
江苏联发纺织股份有限公司	联发股份
杭州远方光电信息股份有限公司	远方信息
中国电力建设股份有限公司	中国电建
王府井集团股份有限公司	王府井
南方中金环境股份有限公司	中金环境
东吴证券股份有限公司	东吴证券
杭州大地海洋环保股份有限公司	大地海洋
浙江乔治白服饰股份有限公司	乔治白
佛燃能源集团股份有限公司	佛燃能源
华纺股份有限公司	华纺股份
东鹏饮料集团股份有限公司	东鹏饮料
广东太安堂药业股份有限公司	太安堂
科华数据股份有限公司	科华数据
浙江大自然户外用品股份有限公司	浙江自然
武商集团股份有限公司	武商集团
奥精医疗科技股份有限公司	奥精医疗
江苏法尔胜股份有限公司	法尔胜
四川观想科技股份有限公司	观想科技
上海妙可蓝多食品科技股份有限公司	妙可蓝多
豆神教育科技北京股份有限公司	豆神教育
河南科迪乳业股份有限公司	科迪乳业
浙江华策影视股份有限公司	华策影视
成都博瑞传播股份有限公司	博瑞传播
广东风华高新科技股份有限公司	风华高科
上海氯碱化工股份有限公司	氯碱化工
北京京城机电股份有限公司	京城股份
山东出版传媒股份有限公司	山东出版
上海保立佳化工股份有限公司	保立佳
华工科技产业股份有限公司	华工科技
福建省燕京惠泉啤酒股份有限公司	惠泉啤酒
宇环数控机床股份有限公司	宇环数控
浙江康隆达特种防护科技股份有限公司	康隆达
天创时尚股份有限公司	天创时尚
上海艾录包装股份有限公司	上海艾录
广州白云国际机场股份有限公司	白云机场
广东创世纪智能装备集团股份有限公司	创世纪
北京光环新网科技股份有限公司	光环新网
恒宇信通航空装备北京股份有限公司	恒宇信通
滨化集团股份有限公司	滨化股份
美年大健康产业控股股份有限公司	美年健康
浙江和仁科技股份有限公司	和仁科技
中信国安葡萄酒业股份有限公司	中葡股份
深圳市捷顺科技实业股份有限公司	捷顺科技
小熊电器股份有限公司	小熊电器
东莞市达瑞电子股份有限公司	达瑞电子
江苏亿通高科技股份有限公司	亿通科技
苏州瑞玛精密工业股份有限公司	瑞玛精密
亚普汽车部件股份有限公司	亚普股份
南通海星电子股份有限公司	海星股份
天津滨海能源发展股份有限公司	滨海能源
浙江大华技术股份有限公司	大华股份
特变电工股份有限公司	特变电工
浙江永贵电器股份有限公司	永贵电器
重庆莱美药业股份有限公司	莱美药业
掌阅科技股份有限公司	掌阅科技
上海吉祥航空股份有限公司	吉祥航空
陈克明食品股份有限公司	克明食品
江西同和药业股份有限公司	同和药业
深水海纳水务集团股份有限公司	深水海纳
江西三鑫医疗科技股份有限公司	三鑫医疗
优德精密工业昆山股份有限公司	优德精密
西安凯立新材料股份有限公司	凯立新材
天邦食品股份有限公司	天邦食品
深圳秋田微电子股份有限公司	秋田微
格尔软件股份有限公司	格尔软件
康平科技苏州股份有限公司	康平科技
浙江银轮机械股份有限公司	银轮股份
宏和电子材料科技股份有限公司	宏和科技
上海凌云实业发展股份有限公司	凌云科技
安徽华业香料股份有限公司	华业香料
成都市兴蓉环境股份有限公司	兴蓉环境
四川和谐双马股份有限公司	四川双马
一汽解放集团股份有限公司	一汽解放
深圳美丽生态股份有限公司	美丽生态
尤洛卡精准信息工程股份有限公司	精准信息
浙江星华新材料集团股份有限公司	星华新材
浙江野马电池股份有限公司	野马电池
江苏三房巷聚材股份有限公司	三房巷
广东广弘控股股份有限公司	广弘控股
华夏航空股份有限公司	华夏航空
深圳市道通科技股份有限公司	道通科技
冰轮环境技术股份有限公司	冰轮环境
通化东宝药业股份有限公司	通化东宝
北京致远互联软件股份有限公司	致远互联
北京歌华有线电视网络股份有限公司	歌华有线
佛山华新包装股份有限公司	华新包装
北汽蓝谷新能源科技股份有限公司	北汽蓝谷
苏宁环球股份有限公司	苏宁环球
博敏电子股份有限公司	博敏电子
青岛东方铁塔股份有限公司	东方铁塔
苏州瑞可达连接系统股份有限公司	瑞可达
深圳市今天国际物流技术股份有限公司	今天国际
江苏如通石油机械股份有限公司	如通股份
中国铁建股份有限公司	中国铁建
广东奇德新材料股份有限公司	奇德新材
鹏博士电信传媒集团股份有限公司	鹏博士
亚士创能科技上海股份有限公司	亚士创能
江铃汽车股份有限公司	江铃汽车
深圳市科达利实业股份有限公司	科达利
浙江省围海建设集团股份有限公司	围海股份
德力西新能源科技股份有限公司	德新科技
腾邦国际商业服务集团股份有限公司	腾邦国际
甘肃酒钢集团宏兴钢铁股份有限公司	酒钢宏兴
北京利尔高温材料股份有限公司	北京利尔
新疆火炬燃气股份有限公司	新疆火炬
中国航发动力股份有限公司	航发动力
湖南和顺石油股份有限公司	和顺石油
大唐国际发电股份有限公司	大唐发电
安徽万朗磁塑股份有限公司	万朗磁塑
安徽盛运环保集团股份有限公司	盛运环保
广发证券股份有限公司	广发证券
北京恒泰实达科技股份有限公司	恒实科技
中交地产股份有限公司	中交地产
开普云信息科技股份有限公司	开普云
深圳市特发服务股份有限公司	特发服务
星辉互动娱乐股份有限公司	星辉娱乐
英飞特电子杭州股份有限公司	英飞特
重庆三圣实业股份有限公司	三圣股份
远东智慧能源股份有限公司	远东股份
凤形股份有限公司	凤形股份
华瑞电器股份有限公司	华瑞股份
神宇通信科技股份公司	神宇股份
四川天味食品集团股份有限公司	天味食品
广东万年青制药股份有限公司	粤万年青
雪龙集团股份有限公司	雪龙集团
世纪天鸿教育科技股份有限公司	世纪天鸿
鲁西化工集团股份有限公司	鲁西化工
欧派家居集团股份有限公司	欧派家居
浙江东亚药业股份有限公司	东亚药业
甘肃祁连山水泥集团股份有限公司	祁连山
浙江亿田智能厨电股份有限公司	亿田智能
福安药业集团股份有限公司	福安药业
金三江肇庆硅材料股份有限公司	金三江
浙江金洲管道科技股份有限公司	金洲管道
广东惠云钛业股份有限公司	惠云钛业
攀钢集团钒钛资源股份有限公司	攀钢钒钛
厦门建霖健康家居股份有限公司	建霖家居
广东德美精细化工集团股份有限公司	德美化工
天马轴承集团股份有限公司	天马股份
冠昊生物科技股份有限公司	冠昊生物
四川路桥建设集团股份有限公司	四川路桥
北京凯因科技股份有限公司	凯因科技
浙江和达科技股份有限公司	和达科技
浙江洁美电子科技股份有限公司	洁美科技
中联重科股份有限公司	中联重科
山西壶化集团股份有限公司	壶化股份
深圳新宙邦科技股份有限公司	新宙邦
麒盛科技股份有限公司	麒盛科技
中国天楹股份有限公司	中国天楹
广东乐心医疗电子股份有限公司	乐心医疗
广东顶固集创家居股份有限公司	顶固集创
云南交投生态科技股份有限公司	交投生态
新华人寿保险股份有限公司	新华保险
骆驼集团股份有限公司	骆驼股份
中国神华能源股份有限公司	中国神华
宜通世纪科技股份有限公司	宜通世纪
祥鑫科技股份有限公司	祥鑫科技
福建顶点软件股份有限公司	顶点软件
浙江东方金融控股集团股份有限公司	浙江东方
中信建投证券股份有限公司	中信建投证券
中国有色金属建设股份有限公司	中色股份
深圳市雄韬电源科技股份有限公司	雄韬股份
甘源食品股份有限公司	甘源食品
烟台睿创微纳技术股份有限公司	睿创微纳
鸿合科技股份有限公司	鸿合科技
永和流体智控股份有限公司	永和智控
浙江新柴股份有限公司	新柴股份
中南出版传媒集团股份有限公司	中南传媒
上海永利带业股份有限公司	永利股份
招商局蛇口工业区控股股份有限公司	招商蛇口
精进电动科技股份有限公司	精进电动
广州高澜节能技术股份有限公司	高澜股份
密尔克卫化工供应链服务股份有限公司	密尔克卫
嘉美食品包装滁州股份有限公司	嘉美包装
浙江晨丰科技股份有限公司	晨丰科技
航天信息股份有限公司	航天信息
北京百纳千成影视股份有限公司	百纳千成
四川迅游网络科技股份有限公司	迅游科技
老百姓大药房连锁股份有限公司	老百姓
上海先惠自动化技术股份有限公司	先惠技术
宇通重工股份有限公司	宇通重工
杭州纵横通信股份有限公司	纵横通信
福建万辰生物科技股份有限公司	万辰生物
中国人民保险集团股份有限公司	中国人保
江苏益客食品集团股份有限公司	益客食品
惠州中京电子科技股份有限公司	中京电子
郑州捷安高科股份有限公司	捷安高科
潜江永安药业股份有限公司	永安药业
中国船舶重工集团应急预警与救援装备股份有限公司	中船应急
上海汉钟精机股份有限公司	汉钟精机
潍柴重机股份有限公司	潍柴重机
广州市聚赛龙工程塑料股份有限公司	聚赛龙
上海农村商业银行股份有限公司	上海农商银行
中触媒新材料股份有限公司	中触媒
海南航空控股股份有限公司	海航控股
长虹美菱股份有限公司	长虹美菱
北京首都开发股份有限公司	首开股份
珠海市乐通化工股份有限公司	乐通股份
鹏起科技发展股份有限公司	鹏起科技
西藏奇正藏药股份有限公司	奇正藏药
上海概伦电子股份有限公司	概伦电子
上海阿拉丁生化科技股份有限公司	阿拉丁
深圳市有方科技股份有限公司	有方科技
永泰能源集团股份有限公司	永泰能源
中青旅控股股份有限公司	中青旅
曙光信息产业股份有限公司	中科曙光
江苏康众数字医疗科技股份有限公司	康众医疗
常州强力电子新材料股份有限公司	强力新材
石家庄以岭药业股份有限公司	以岭药业
富奥汽车零部件股份有限公司	富奥股份
宁波精达成形装备股份有限公司	宁波精达
上海凯宝药业股份有限公司	上海凯宝
安徽新华传媒股份有限公司	皖新传媒
宁波天益医疗器械股份有限公司	天益医疗
武汉光庭信息技术股份有限公司	光庭信息
广东冠豪高新技术股份有限公司	冠豪高新
湖南博云新材料股份有限公司	博云新材
华斯控股股份有限公司	华斯股份
爱玛科技集团股份有限公司	爱玛科技
山东华泰纸业股份有限公司	华泰股份
贤丰控股股份有限公司	贤丰控股
湖南凯美特气体股份有限公司	凯美特气
云南贝泰妮生物科技集团股份有限公司	贝泰妮
成都运达科技股份有限公司	运达科技
英科医疗科技股份有限公司	英科医疗
中国平安保险集团股份有限公司	中国平安
威创集团股份有限公司	威创股份
北京左江科技股份有限公司	左江科技
贵州川恒化工股份有限公司	川恒股份
成都银河磁体股份有限公司	银河磁体
万方城镇投资发展股份有限公司	万方发展
南京科思化学股份有限公司	科思股份
浙江亿利达风机股份有限公司	亿利达
上海电气集团股份有限公司	上海电气
湖北九有投资股份有限公司	九有股份
浙江奥康鞋业股份有限公司	奥康国际
深圳市金百泽电子科技股份有限公司	金百泽
深圳市优博讯科技股份有限公司	优博讯
海尔智家股份有限公司	海尔智家
中节能风力发电股份有限公司	节能风电
荣安地产股份有限公司	荣安地产
上海新世界股份有限公司	新世界
中再资源环境股份有限公司	中再资环
北京数码视讯科技股份有限公司	数码视讯
西安康拓医疗技术股份有限公司	康拓医疗
西安银行股份有限公司	西安银行
浙江祥源文旅股份有限公司	祥源文旅
上海爱婴室商务服务股份有限公司	爱婴室
蒙草生态环境集团股份有限公司	蒙草生态
天津津荣天宇精密机械股份有限公司	津荣天宇
浙江震元股份有限公司	浙江震元
河南百川畅银环保能源股份有限公司	百川畅银
深圳市昌红科技股份有限公司	昌红科技
比音勒芬服饰股份有限公司	比音勒芬
北京建工环境修复股份有限公司	建工修复
深圳市郑中设计股份有限公司	郑中设计
诺力智能装备股份有限公司	诺力股份
华自科技股份有限公司	华自科技
无锡双象超纤材料股份有限公司	双象股份
重庆长江造型材料集团股份有限公司	长江材料
汇中仪表股份有限公司	汇中股份
大连友谊集团股份有限公司	大连友谊
湖北凯乐科技股份有限公司	凯乐科技
北京华力创通科技股份有限公司	华力创通
国泰君安证券股份有限公司	国泰君安
华鹏飞股份有限公司	华鹏飞
四川蜀道装备科技股份有限公司	蜀道装备
甘肃亚太实业发展股份有限公司	亚太实业
新疆大全新能源股份有限公司	大全能源
浙江海正药业股份有限公司	海正药业
上海宝信软件股份有限公司	宝信软件
深圳拓邦股份有限公司	拓邦股份
西域旅游开发股份有限公司	西域旅游
东方集团股份有限公司	东方集团
华达汽车科技股份有限公司	华达科技
浙江锋龙电气股份有限公司	锋龙股份
江苏华昌化工股份有限公司	华昌化工
广东群兴玩具股份有限公司	群兴玩具
杭州西力智能科技股份有限公司	西力科技
福耀玻璃工业集团股份有限公司	福耀玻璃
浙江东望时代科技股份有限公司	东望时代
安徽金禾实业股份有限公司	金禾实业
湖北台基半导体股份有限公司	台基股份
湖南华菱钢铁股份有限公司	华菱钢铁
金雷科技股份公司	金雷股份
浙江久立特材科技股份有限公司	久立特材
亚光科技集团股份有限公司	亚光科技
营口金辰机械股份有限公司	金辰股份
华闻传媒投资集团股份有限公司	华闻集团
中电科芯片技术股份有限公司	电科芯片
中原内配集团股份有限公司	中原内配
国联证券股份有限公司	国联证券
上海洗霸科技股份有限公司	上海洗霸
苏州艾隆科技股份有限公司	艾隆科技
青岛海泰科模塑科技股份有限公司	海泰科
深圳华控赛格股份有限公司	华控赛格
浙江华达新型材料股份有限公司	华达新材
立方数科股份有限公司	立方数科
广东香山衡器集团股份有限公司	香山股份
浙江大洋生物科技集团股份有限公司	大洋生物
河钢股份有限公司	河钢股份
宁波恒帅股份有限公司	恒帅股份
深圳翰宇药业股份有限公司	翰宇药业
顾家家居股份有限公司	顾家家居
开勒环境科技上海股份有限公司	开勒股份
邵阳维克液压股份有限公司	邵阳液压
山东科汇电力自动化股份有限公司	科汇股份
中远海运发展股份有限公司	中远海发
浙江蓝特光学股份有限公司	蓝特光学
上海正帆科技股份有限公司	正帆科技
上海宽频科技股份有限公司	上海科技
江苏云涌电子科技股份有限公司	云涌科技
国旅文化投资集团股份有限公司	国旅文化
威海光威复合材料股份有限公司	光威复材
金洲慈航集团股份有限公司	金洲慈航
浙江省新能源投资集团股份有限公司	浙江新能
起步股份有限公司	起步股份
山东金麒麟股份有限公司	金麒麟
人人乐连锁商业集团股份有限公司	人人乐
合肥工大高科信息科技股份有限公司	工大高科
重庆三峰环境集团股份有限公司	三峰环境
北京双杰电气股份有限公司	双杰电气
新疆天富能源股份有限公司	天富能源
优刻得科技股份有限公司	优刻得
安徽六国化工股份有限公司	六国化工
北京超图软件股份有限公司	超图软件
万凯新材料股份有限公司	万凯新材
安徽德力日用玻璃股份有限公司	德力股份
北京航天长峰股份有限公司	航天长峰
中国船舶重工股份有限公司	中国重工
安徽华骐环保科技股份有限公司	华骐环保
棕榈生态城镇发展股份有限公司	棕榈股份
苏美达股份有限公司	苏美达
无锡洪汇新材料科技股份有限公司	洪汇新材
中铁装配式建筑股份有限公司	中铁装配
中国中材国际工程股份有限公司	中材国际
锐奇控股股份有限公司	锐奇股份
浙江网盛生意宝股份有限公司	生意宝
皓宸医疗科技股份有限公司	皓宸医疗
北京中科三环高技术股份有限公司	中科三环
宁波波导股份有限公司	波导股份
中材节能股份有限公司	中材节能
湖北祥源新材科技股份有限公司	祥源新材
云南旅游股份有限公司	云南旅游
鹏鼎控股深圳股份有限公司	鹏鼎控股
江苏日久光电股份有限公司	日久光电
恒盛能源股份有限公司	恒盛能源
杭州平治信息技术股份有限公司	平治信息
甘肃刚泰控股集团股份有限公司	刚泰控股
华润三九医药股份有限公司	华润三九
苏州明志科技股份有限公司	明志科技
正平路桥建设股份有限公司	正平股份
深圳市安车检测股份有限公司	安车检测
新湖中宝股份有限公司	新湖中宝
安徽中电兴发与鑫龙科技股份有限公司	中电兴发
深圳世联行集团股份有限公司	世联行
金徽酒股份有限公司	金徽酒
江苏金智科技股份有限公司	金智科技
东杰智能科技集团股份有限公司	东杰智能
深圳可立克科技股份有限公司	可立克
江苏润和软件股份有限公司	润和软件
南方出版传媒股份有限公司	南方传媒
浙江拱东医疗器械股份有限公司	拱东医疗
新兴铸管股份有限公司	新兴铸管
广东正业科技股份有限公司	正业科技
西藏高争民爆股份有限公司	高争民爆
青岛蔚蓝生物股份有限公司	蔚蓝生物
上海新南洋昂立教育科技股份有限公司	昂立教育
中际联合北京科技股份有限公司	中际联合
海南天然橡胶产业集团股份有限公司	海南橡胶
神马实业股份有限公司	神马股份
上海华测导航技术股份有限公司	华测导航
杭州诺邦无纺股份有限公司	诺邦股份
浙江李子园食品股份有限公司	李子园
山东潍坊润丰化工股份有限公司	润丰股份
武汉天喻信息产业股份有限公司	天喻信息
杭州美迪凯光电科技股份有限公司	美迪凯
贵州省交通规划勘察设计研究院股份有限公司	勘设股份
广州万孚生物技术股份有限公司	万孚生物
青岛农村商业银行股份有限公司	青农商行
湖北共同药业股份有限公司	共同药业
上海万业企业股份有限公司	万业企业
北京弘高创意建筑设计股份有限公司	弘高创意
重庆四方新材股份有限公司	四方新材
上海霍莱沃电子系统技术股份有限公司	霍莱沃
建发合诚工程咨询股份有限公司	建发合诚
宁波海运股份有限公司	宁波海运
广东博力威科技股份有限公司	博力威
中国国际海运集装箱集团股份有限公司	中集集团
埃夫特智能装备股份有限公司	埃夫特
国信证券股份有限公司	国信证券
亚宝药业集团股份有限公司	亚宝药业
江苏正威新材料股份有限公司	正威新材
北京海天瑞声科技股份有限公司	海天瑞声
思美传媒股份有限公司	思美传媒
文一三佳科技股份有限公司	文一科技
江苏雷科防务科技股份有限公司	雷科防务
中红普林医疗用品股份有限公司	中红医疗
科大国盾量子技术股份有限公司	国盾量子
浙商银行股份有限公司	浙商银行
富满微电子集团股份有限公司	富满微
广东拓斯达科技股份有限公司	拓斯达
宁波康强电子股份有限公司	康强电子
宁波富邦精业集团股份有限公司	宁波富邦
江苏索普化工股份有限公司	江苏索普
新城控股集团股份有限公司	新城控股
阳光城集团股份有限公司	阳光城
江苏正丹化学工业股份有限公司	正丹股份
北京中科海讯数字科技股份有限公司	中科海讯
浙江大元泵业股份有限公司	大元泵业
山东晨鸣纸业集团股份有限公司	晨鸣纸业
浙江金科汤姆猫文化产业股份有限公司	汤姆猫
锦州神工半导体股份有限公司	神工股份
上海现代制药股份有限公司	国药现代
冀中能源股份有限公司	冀中能源
龙佰集团股份有限公司	龙佰集团
瑞芯微电子股份有限公司	瑞芯微
山东隆华新材料股份有限公司	隆华新材
金龙羽集团股份有限公司	金龙羽
四川水井坊股份有限公司	水井坊
筑博设计股份有限公司	筑博设计
青岛云路先进材料技术股份有限公司	云路股份
金诚信矿业管理股份有限公司	金诚信
北京乾景园林股份有限公司	乾景园林
光一科技股份有限公司	光一科技
上海神开石油化工装备股份有限公司	神开股份
武汉三镇实业控股股份有限公司	武汉控股
中顺洁柔纸业股份有限公司	中顺洁柔
常州朗博密封科技股份有限公司	朗博科技
深圳市金证科技股份有限公司	金证股份
新疆熙菱信息技术股份有限公司	熙菱信息
北京京运通科技股份有限公司	京运通
哈尔滨空调股份有限公司	哈空调
辽宁时代万恒股份有限公司	时代万恒
泰尔重工股份有限公司	泰尔股份
安徽古井贡酒股份有限公司	古井贡酒
江苏精研科技股份有限公司	精研科技
江苏秀强玻璃工艺股份有限公司	秀强股份
天津银龙预应力材料股份有限公司	银龙股份
广东柏堡龙股份有限公司	柏堡龙
新乡市瑞丰新材料股份有限公司	瑞丰新材
焦点科技股份有限公司	焦点科技
湖北五方光电股份有限公司	五方光电
吉林泉阳泉股份有限公司	泉阳泉
河南双汇投资发展股份有限公司	双汇发展
上海华依科技集团股份有限公司	华依科技
浙江东南网架股份有限公司	东南网架
东方时尚驾驶学校股份有限公司	东方时尚
南京寒锐钴业股份有限公司	寒锐钴业
四川东材科技集团股份有限公司	东材科技
宁波理工环境能源科技股份有限公司	理工能科
中节能太阳能股份有限公司	太阳能
深圳市聚飞光电股份有限公司	聚飞光电
安徽荃银高科种业股份有限公司	荃银高科
海洋王照明科技股份有限公司	海洋王
海南神农科技股份有限公司	神农科技
江西万年青水泥股份有限公司	万年青
南京医药股份有限公司	南京医药
山东好当家海洋发展股份有限公司	好当家
镇江东方电热科技股份有限公司	东方电热
苏州泽璟生物制药股份有限公司	泽璟制药
北京合康新能科技股份有限公司	合康新能
中广天择传媒股份有限公司	中广天择
金浦钛业股份有限公司	金浦钛业
上海二三四五网络控股集团股份有限公司	二三四五
路德环境科技股份有限公司	路德环境
吉林省西点药业科技发展股份有限公司	西点药业
上纬新材料科技股份有限公司	上纬新材
安福县海能实业股份有限公司	海能实业
立中四通轻合金集团股份有限公司	立中集团
海波重型工程科技股份有限公司	海波重科
宁夏西部创业实业股份有限公司	西部创业
长春英利汽车工业股份有限公司	英利汽车
山东鲁阳节能材料股份有限公司	鲁阳节能
青岛鼎信通讯股份有限公司	鼎信通讯
深圳市兴森快捷电路科技股份有限公司	兴森科技
上海复旦张江生物医药股份有限公司	复旦张江
康希诺生物股份公司	康希诺
郑州银行股份有限公司	郑州银行
浙江华康药业股份有限公司	华康股份
山东民和牧业股份有限公司	民和股份
江苏嵘泰工业股份有限公司	嵘泰股份
山东威达机械股份有限公司	山东威达
厦门艾德生物医药科技股份有限公司	艾德生物
厦门港务发展股份有限公司	厦门港务
杭州永创智能设备股份有限公司	永创智能
中达安股份有限公司	中达安
天津桂发祥十八街麻花食品股份有限公司	桂发祥
中石化石油工程技术服务股份有限公司	石化油服
海南双成药业股份有限公司	双成药业
江苏宏微科技股份有限公司	宏微科技
深圳市普路通供应链管理股份有限公司	普路通
湖北楚天智能交通股份有限公司	楚天高速
垒知控股集团股份有限公司	垒知集团
芯原微电子上海股份有限公司	芯原股份
浙江臻镭科技股份有限公司	臻镭科技
深圳迈瑞生物医疗电子股份有限公司	迈瑞医疗
云南临沧鑫圆锗业股份有限公司	云南锗业
宁波高发汽车控制系统股份有限公司	宁波高发
广州珠江钢琴集团股份有限公司	珠江钢琴
珠海华金资本股份有限公司	华金资本
深圳市雄帝科技股份有限公司	雄帝科技
东珠生态环保股份有限公司	东珠生态
深圳市力合微电子股份有限公司	力合微
河北衡水老白干酒业股份有限公司	老白干酒
重庆港股份有限公司	重庆港
猛狮新能源科技河南股份有限公司	猛狮科技
北海国发川山生物股份有限公司	国发股份
宏达高科控股股份有限公司	宏达高科
谱尼测试集团股份有限公司	谱尼测试
厦门力鼎光电股份有限公司	力鼎光电
光明乳业股份有限公司	光明乳业
合肥合锻智能制造股份有限公司	合锻智能
重庆华森制药股份有限公司	华森制药
华西能源工业股份有限公司	华西能源
新智认知数字科技股份有限公司	新智认知
湖南华民控股集团股份有限公司	华民股份
新疆北新路桥集团股份有限公司	北新路桥
新华文轩出版传媒股份有限公司	新华文轩
中建环能科技股份有限公司	中建环能
江苏洋河酒厂股份有限公司	洋河股份
新疆亿路万源实业控股股份有限公司	新亿股份
梦百合家居科技股份有限公司	梦百合
福建省招标股份有限公司	招标股份
无锡芯朋微电子股份有限公司	芯朋微
青岛海泰新光科技股份有限公司	海泰新光
上海金枫酒业股份有限公司	金枫酒业
广东超华科技股份有限公司	超华科技
青岛中资中程集团股份有限公司	青岛中程
上海维宏电子科技股份有限公司	维宏股份
南通国盛智能科技集团股份有限公司	国盛智科
深圳市机场股份有限公司	深圳机场
浙江今飞凯达轮毂股份有限公司	今飞凯达
健民药业集团股份有限公司	健民集团
广州弘亚数控机械股份有限公司	弘亚数控
江苏江南水务股份有限公司	江南水务
江西世龙实业股份有限公司	世龙实业
新疆鑫泰天然气股份有限公司	新天然气
北京海新能源科技股份有限公司	海新能科
芜湖富春染织股份有限公司	富春染织
广州达意隆包装机械股份有限公司	达意隆
广东迪生力汽配股份有限公司	迪生力
好利来中国电子科技股份有限公司	好利科技
中国农业银行股份有限公司	农业银行
深圳市盛讯达科技股份有限公司	盛讯达
苏州易德龙科技股份有限公司	易德龙
元利化学集团股份有限公司	元利科技
安徽华恒生物科技股份有限公司	华恒生物
时代出版传媒股份有限公司	时代出版
武汉光迅科技股份有限公司	光迅科技
湖北美尔雅股份有限公司	美尔雅
浙江景兴纸业股份有限公司	景兴纸业
杭州海兴电力科技股份有限公司	海兴电力
河南省力量钻石股份有限公司	力量钻石
冠捷电子科技股份有限公司	冠捷科技
华泰证券股份有限公司	华泰证券
山西潞安环保能源开发股份有限公司	潞安环能
江苏红豆实业股份有限公司	红豆股份
浙江万里扬股份有限公司	万里扬
启迪药业集团股份公司	启迪药业
中粮资本控股股份有限公司	中粮资本
光大证券股份有限公司	光大证券
宁波润禾高新材料科技股份有限公司	润禾材料
阳光新业地产股份有限公司	阳光股份
倍杰特集团股份有限公司	倍杰特
无锡路通视信网络股份有限公司	路通视信
浙江芯能光伏科技股份有限公司	芯能科技
上海芯导电子科技股份有限公司	芯导科技
深圳市长方集团股份有限公司	长方集团
成都燃气集团股份有限公司	成都燃气
湖北富邦科技股份有限公司	富邦股份
黑龙江交通发展股份有限公司	龙江交通
深圳市广聚能源股份有限公司	广聚能源
厦门嘉戎技术股份有限公司	嘉戎技术
西安博通资讯股份有限公司	博通股份
齐鲁银行股份有限公司	齐鲁银行
黄山旅游发展股份有限公司	黄山旅游
江西煌上煌集团食品股份有限公司	煌上煌
石药集团新诺威制药股份有限公司	新诺威
中自环保科技股份有限公司	中自科技
苏州华源控股股份有限公司	华源控股
宁波大叶园林设备股份有限公司	大叶股份
国电南京自动化股份有限公司	国电南自
深圳市天地集团股份有限公司	深天地
浙商中拓集团股份有限公司	浙商中拓
大连德迈仕精密科技股份有限公司	德迈仕
上海新致软件股份有限公司	新致软件
浙江龙盛集团股份有限公司	浙江龙盛
腾达建设集团股份有限公司	腾达建设
铜陵精达特种电磁线股份有限公司	精达股份
广州赛意信息科技股份有限公司	赛意信息
深圳市新南山控股集团股份有限公司	南山控股
西安铂力特增材技术股份有限公司	铂力特
鞍钢股份有限公司	鞍钢股份
益海嘉里金龙鱼粮油食品股份有限公司	金龙鱼
中国民生银行股份有限公司	民生银行
湖南方盛制药股份有限公司	方盛制药
深圳市华阳国际工程设计股份有限公司	华阳国际
青海春天药用资源科技股份有限公司	青海春天
山东矿机集团股份有限公司	山东矿机
深圳长城开发科技股份有限公司	深科技
上海机电股份有限公司	上海机电
中衡设计集团股份有限公司	中衡设计
宁波继峰汽车零部件股份有限公司	继峰股份
黑龙江国中水务股份有限公司	国中水务
京能置业股份有限公司	京能置业
厦门光莆电子股份有限公司	光莆股份
海目星激光科技集团股份有限公司	海目星
营口风光新材料股份有限公司	风光股份
大富科技安徽股份有限公司	大富科技
浙江省建设投资集团股份有限公司	浙江建投
统一低碳科技新疆股份有限公司	统一股份
浙江中控技术股份有限公司	中控技术
中国海诚工程科技股份有限公司	中国海诚
同兴环保科技股份有限公司	同兴环保
湖北济川药业股份有限公司	济川药业
聚光科技杭州股份有限公司	聚光科技
深圳市信濠光电科技股份有限公司	信濠光电
安徽金春无纺布股份有限公司	金春股份
深圳市名雕装饰股份有限公司	名雕股份
杭州天目山药业股份有限公司	天目药业
江苏吉鑫风能科技股份有限公司	吉鑫科技
重庆钢铁股份有限公司	重庆钢铁
杭州园林设计院股份有限公司	杭州园林
成都纵横自动化技术股份有限公司	纵横股份
四川升达林业产业股份有限公司	升达林业
奥士康科技股份有限公司	奥士康
吉艾科技集团股份公司	吉艾科技
上海港湾基础建设集团股份有限公司	上海港湾
华邦生命健康股份有限公司	华邦健康
华扬联众数字技术股份有限公司	华扬联众
江苏博云塑业股份有限公司	江苏博云
江苏聚杰微纤科技集团股份有限公司	聚杰微纤
深圳市麦捷微电子科技股份有限公司	麦捷科技
江苏康缘药业股份有限公司	康缘药业
芜湖伯特利汽车安全系统股份有限公司	伯特利
新疆汇嘉时代百货股份有限公司	汇嘉时代
日海智能科技股份有限公司	日海智能
深圳市朗科智能电气股份有限公司	朗科智能
深圳市汇创达科技股份有限公司	汇创达
一心堂药业集团股份有限公司	一心堂
上海罗曼照明科技股份有限公司	罗曼股份
中节能环保装备股份有限公司	中环装备
浙商证券股份有限公司	浙商证券
深圳市朗科科技股份有限公司	朗科科技
中科软科技股份有限公司	中科软
湖南黄金股份有限公司	湖南黄金
北京值得买科技股份有限公司	值得买
五矿资本股份有限公司	五矿资本
广东省广告集团股份有限公司	省广集团
江苏东方盛虹股份有限公司	东方盛虹
北京数知科技股份有限公司	数知科技
南京佳力图机房环境技术股份有限公司	佳力图
四川西昌电力股份有限公司	西昌电力
东旭蓝天新能源股份有限公司	东旭蓝天
中国东方航空股份有限公司	中国东航
深圳惠泰医疗器械股份有限公司	惠泰医疗
安正时尚集团股份有限公司	安正时尚
山东省章丘鼓风机股份有限公司	山东章鼓
上海岱美汽车内饰件股份有限公司	岱美股份
天马微电子股份有限公司	深天马A
瀛通通讯股份有限公司	瀛通通讯
宁波市天普橡胶科技股份有限公司	天普股份
上海易连实业集团股份有限公司	上海易连
上海透景生命科技股份有限公司	透景生命
新光圆成股份有限公司	新光圆成
多伦科技股份有限公司	多伦科技
上海新时达电气股份有限公司	新时达
福州达华智能科技股份有限公司	达华智能
鞍山重型矿山机器股份有限公司	鞍重股份
深圳市澄天伟业科技股份有限公司	澄天伟业
东江环保股份有限公司	东江环保
楚天龙股份有限公司	楚天龙
安徽中环环保科技股份有限公司	中环环保
英洛华科技股份有限公司	英洛华
超讯通信股份有限公司	超讯通信
广西柳药集团股份有限公司	柳药集团
浙江梅轮电梯股份有限公司	梅轮电梯
中铁高铁电气装备股份有限公司	高铁电气
中颖电子股份有限公司	中颖电子
上海雅创电子集团股份有限公司	雅创电子
深圳汇洁集团股份有限公司	汇洁股份
山东丰元化学股份有限公司	丰元股份
上海开开实业股份有限公司	开开实业
长虹华意压缩机股份有限公司	长虹华意
沈阳化工股份有限公司	沈阳化工
江苏博俊工业科技股份有限公司	博俊科技
山西太钢不锈钢股份有限公司	太钢不锈
东北证券股份有限公司	东北证券
中密控股股份有限公司	中密控股
招商证券股份有限公司	招商证券
爱仕达股份有限公司	爱仕达
好想你健康食品股份有限公司	好想你
武汉中元华电科技股份有限公司	中元股份
徐州海伦哲专用车辆股份有限公司	海伦哲
宸展光电厦门股份有限公司	宸展光电
浙江嘉化能源化工股份有限公司	嘉化能源
亿帆医药股份有限公司	亿帆医药
河南大有能源股份有限公司	大有能源
广州粤泰集团股份有限公司	粤泰股份
北京亿华通科技股份有限公司	亿华通
申联生物医药上海股份有限公司	申联生物
晋西车轴股份有限公司	晋西车轴
中科微至科技股份有限公司	中科微至
中国太平洋保险集团股份有限公司	中国太保
江苏亨通光电股份有限公司	亨通光电
芒果超媒股份有限公司	芒果超媒
无锡药明康德新药开发股份有限公司	药明康德
迈得医疗工业设备股份有限公司	迈得医疗
春秋航空股份有限公司	春秋航空
北京零点有数数据科技股份有限公司	零点有数
南方电网综合能源股份有限公司	南网能源
中化国际控股股份有限公司	中化国际
天域生态环境股份有限公司	天域生态
新疆八一钢铁股份有限公司	八一钢铁
南京证券股份有限公司	南京证券
美盛文化创意股份有限公司	美盛文化
安徽英力电子科技股份有限公司	英力股份
中国人寿保险股份有限公司	中国人寿
用友网络科技股份有限公司	用友网络
安徽元琛环保科技股份有限公司	元琛科技
厦门银行股份有限公司	厦门银行
江苏通灵电器股份有限公司	通灵股份
吴通控股集团股份有限公司	吴通控股
成都新易盛通信技术股份有限公司	新易盛
南京宝色股份公司	宝色股份
杭州立昂微电子股份有限公司	立昂微
广州海鸥住宅工业股份有限公司	海鸥住工
上海天玑科技股份有限公司	天玑科技
深圳光峰科技股份有限公司	光峰科技
上海飞科电器股份有限公司	飞科电器
温州宏丰电工合金股份有限公司	温州宏丰
联美量子股份有限公司	联美控股
宏发科技股份有限公司	宏发股份
江西华伍制动器股份有限公司	华伍股份
桂林三金药业股份有限公司	桂林三金
中泰证券股份有限公司	中泰证券
公牛集团股份有限公司	公牛集团
福建永福电力设计股份有限公司	永福股份
皇氏集团股份有限公司	皇氏集团
南京新街口百货商店股份有限公司	南京新百
信达地产股份有限公司	信达地产
深圳市新国都股份有限公司	新国都
珠海港股份有限公司	珠海港
公元股份有限公司	公元股份
国金证券股份有限公司	国金证券
苏州华亚智能科技股份有限公司	华亚智能
沪士电子股份有限公司	沪电股份
江苏宝馨科技股份有限公司	宝馨科技
龙建路桥股份有限公司	龙建股份
广州市嘉诚国际物流股份有限公司	嘉诚国际
迈克生物股份有限公司	迈克生物
恒立实业发展集团股份有限公司	恒立实业
新疆天山水泥股份有限公司	天山股份
玉禾田环境发展集团股份有限公司	玉禾田
西宁特殊钢股份有限公司	西宁特钢
宁波先锋新材料股份有限公司	先锋新材
上海优宁维生物科技股份有限公司	优宁维
南宁百货大楼股份有限公司	南宁百货
江苏亚太轻合金科技股份有限公司	亚太科技
中国石油天然气股份有限公司	中国石油
四川西部资源控股股份有限公司	西部资源
甘肃金刚光伏股份有限公司	金刚光伏
北京热景生物技术股份有限公司	热景生物
深圳传音控股股份有限公司	传音控股
上海南方模式生物科技股份有限公司	南模生物
海南机场设施股份有限公司	海南机场
山东东宏管业股份有限公司	东宏股份
上海永冠众诚新材料科技集团股份有限公司	永冠新材
中国卫通集团股份有限公司	中国卫通
上海电影股份有限公司	上海电影
山东高速路桥集团股份有限公司	山东路桥
中国全聚德集团股份有限公司	全聚德
华谊兄弟传媒股份有限公司	华谊兄弟
上海网达软件股份有限公司	网达软件
武汉东湖高新集团股份有限公司	东湖高新
广东希荻微电子股份有限公司	希荻微
红宝丽集团股份有限公司	红宝丽
北京中迪投资股份有限公司	中迪投资
广东东方锆业科技股份有限公司	东方锆业
江苏张家港农村商业银行股份有限公司	张家港行
浙江健盛集团股份有限公司	健盛集团
南京迪威尔高端制造股份有限公司	迪威尔
安徽富煌钢构股份有限公司	富煌钢构
中电科普天科技股份有限公司	普天科技
北京雪迪龙科技股份有限公司	雪迪龙
创业慧康科技股份有限公司	创业慧康
江苏亚虹医药科技股份有限公司	亚虹医药
天通控股股份有限公司	天通股份
金安国纪集团股份有限公司	金安国纪
惠州市德赛西威汽车电子股份有限公司	德赛西威
陕西盘龙药业集团股份有限公司	盘龙药业
紫光股份有限公司	紫光股份
江龙船艇科技股份有限公司	江龙船艇
中海油能源发展股份有限公司	海油发展
中牧实业股份有限公司	中牧股份
阜新德尔汽车部件股份有限公司	德尔股份
河南羚锐制药股份有限公司	羚锐制药
安徽省交通建设股份有限公司	交建股份
深圳市佳创视讯技术股份有限公司	佳创视讯
新华网股份有限公司	新华网
济南圣泉集团股份有限公司	圣泉集团
创意信息技术股份有限公司	创意信息
采纳科技股份有限公司	采纳股份
深圳市英可瑞科技股份有限公司	英可瑞
江苏恩华药业股份有限公司	恩华药业
东莞市华立实业股份有限公司	华立股份
成都大宏立机器股份有限公司	大宏立
杭州长川科技股份有限公司	长川科技
贵研铂业股份有限公司	贵研铂业
广西丰林木业集团股份有限公司	丰林集团
烟台石川密封科技股份有限公司	密封科技
上能电气股份有限公司	上能电气
江苏通达动力科技股份有限公司	通达动力
电光防爆科技股份有限公司	电光科技
河南安彩高科股份有限公司	安彩高科
浙江世纪华通集团股份有限公司	世纪华通
富临精工股份有限公司	富临精工
北京华宇软件股份有限公司	华宇软件
山西焦煤能源集团股份有限公司	山西焦煤
广联航空工业股份有限公司	广联航空
江苏锦鸡实业股份有限公司	锦鸡股份
圣邦微电子北京股份有限公司	圣邦股份
北京新时空科技股份有限公司	时空科技
东北制药集团股份有限公司	东北制药
品渥食品股份有限公司	品渥食品
飞天诚信科技股份有限公司	飞天诚信
山东东方海洋科技股份有限公司	东方海洋
纳思达股份有限公司	纳思达
中国西电电气股份有限公司	中国西电
上海保隆汽车科技股份有限公司	保隆科技
安集微电子科技上海股份有限公司	安集科技
百隆东方股份有限公司	百隆东方
兰州银行股份有限公司	兰州银行
金开新能源股份有限公司	金开新能
中节能铁汉生态环境股份有限公司	节能铁汉
中信国安信息产业股份有限公司	中信国安
江苏裕兴薄膜科技股份有限公司	裕兴股份
宁波博威合金材料股份有限公司	博威合金
甘肃亚盛实业集团股份有限公司	亚盛集团
海螺安徽节能环保新材料股份有限公司	海螺新材
长高电新科技股份公司	长高电新
江苏银行股份有限公司	江苏银行
齐峰新材料股份有限公司	齐峰新材
浙江开尔新材料股份有限公司	开尔新材
通富微电子股份有限公司	通富微电
深圳市强瑞精密技术股份有限公司	强瑞技术
南通星球石墨股份有限公司	星球石墨
锦州永杉锂业股份有限公司	永杉锂业
科顺防水科技股份有限公司	科顺股份
西安天和防务技术股份有限公司	天和防务
重庆农村商业银行股份有限公司	渝农商行
江苏林洋能源股份有限公司	林洋能源
山东中锐产业发展股份有限公司	中锐股份
东方日升新能源股份有限公司	东方日升
内蒙古大中矿业股份有限公司	大中矿业
康欣新材料股份有限公司	康欣新材
江苏迈信林航空科技股份有限公司	迈信林
中国国际金融股份有限公司	中金公司
三祥新材股份有限公司	三祥新材
华润双鹤药业股份有限公司	华润双鹤
浙江迦南科技股份有限公司	迦南科技
金融街控股股份有限公司	金融街
澜起科技股份有限公司	澜起科技
湖北鼎龙控股股份有限公司	鼎龙股份
株洲时代新材料科技股份有限公司	时代新材
浙江越剑智能装备股份有限公司	越剑智能
西子清洁能源装备制造股份有限公司	西子洁能
天津膜天膜科技股份有限公司	津膜科技
浙富控股集团股份有限公司	浙富控股
深圳世纪星源股份有限公司	世纪星源
浙江司太立制药股份有限公司	司太立
山东道恩高分子材料股份有限公司	道恩股份
浩云科技股份有限公司	浩云科技
江苏江阴农村商业银行股份有限公司	江阴银行
上海复星医药集团股份有限公司	复星医药
杭州中威电子股份有限公司	中威电子
河北养元智汇饮品股份有限公司	养元饮品
上海建工集团股份有限公司	上海建工
海南钧达新能源科技股份有限公司	钧达股份
厚普清洁能源集团股份有限公司	厚普股份
福建阿石创新材料股份有限公司	阿石创
广东炬申物流股份有限公司	炬申股份
郑州煤矿机械集团股份有限公司	郑煤机
深圳友讯达科技股份有限公司	友讯达
承德露露股份公司	承德露露
江苏新日电动车股份有限公司	新日股份
杭州博拓生物科技股份有限公司	博拓生物
红塔证券股份有限公司	红塔证券
深圳市证通电子股份有限公司	证通电子
杭萧钢构股份有限公司	杭萧钢构
四川雅化实业集团股份有限公司	雅化集团
奥普家居股份有限公司	奥普家居
湖北亨迪药业股份有限公司	亨迪药业
厦门东亚机械工业股份有限公司	东亚机械
贵阳银行股份有限公司	贵阳银行
武汉海特生物制药股份有限公司	海特生物
上海联明机械股份有限公司	联明股份
宁夏青龙管业集团股份有限公司	青龙管业
浙江华海药业股份有限公司	华海药业
江西沃格光电股份有限公司	沃格光电
山东东岳有机硅材料股份有限公司	东岳硅材
广东东箭汽车科技股份有限公司	东箭科技
索菲亚家居股份有限公司	索菲亚
湖南尔康制药股份有限公司	尔康制药
宁夏宝丰能源集团股份有限公司	宝丰能源
深圳市瑞丰光电子股份有限公司	瑞丰光电
智度科技股份有限公司	智度股份
广东凌霄泵业股份有限公司	凌霄泵业
珠海英搏尔电气股份有限公司	英搏尔
广东世荣兆业股份有限公司	世荣兆业
深圳市利和兴股份有限公司	利和兴
北京汉邦高科数字技术股份有限公司	汉邦高科
绿田机械股份有限公司	绿田机械
天下秀数字科技集团股份有限公司	天下秀
鹏欣环球资源股份有限公司	鹏欣资源
中国工商银行股份有限公司	工商银行
卧龙电气驱动集团股份有限公司	卧龙电驱
吉林华微电子股份有限公司	华微电子
浙江金沃精工股份有限公司	金沃股份
合肥城建发展股份有限公司	合肥城建
深圳市维业装饰集团股份有限公司	维业股份
云南罗平锌电股份有限公司	罗平锌电
东软集团股份有限公司	东软集团
华域汽车系统股份有限公司	华域汽车
昆山国力电子科技股份有限公司	国力股份
东莞宏远工业区股份有限公司	粤宏远
山东省药用玻璃股份有限公司	山东药玻
宁波金田铜业集团股份有限公司	金田股份
广州市浩洋电子股份有限公司	浩洋股份
杭州华光焊接新材料股份有限公司	华光新材
江苏协和电子股份有限公司	协和电子
长沙景嘉微电子股份有限公司	景嘉微
中国电器科学研究院股份有限公司	中国电研
晶晨半导体上海股份有限公司	晶晨股份
上海钢联电子商务股份有限公司	上海钢联
北京诺禾致源科技股份有限公司	诺禾致源
中安科股份有限公司	中安科
浙江汇隆新材料股份有限公司	汇隆新材
深圳市纺织集团股份有限公司	深纺织
苏州恒铭达电子科技股份有限公司	恒铭达
宁夏中银绒业股份有限公司	中银绒业
启明星辰信息技术集团股份有限公司	启明星辰
久盛电气股份有限公司	久盛电气
浙江哈尔斯真空器皿股份有限公司	哈尔斯
乐视网信息技术北京股份有限公司	乐视网
东华能源股份有限公司	东华能源
杭州热电集团股份有限公司	杭州热电
佛山市南华仪器股份有限公司	南华仪器
宁波中百股份有限公司	宁波中百
西部超导材料科技股份有限公司	西部超导
江苏海力风电设备科技股份有限公司	海力风电
广州山水比德设计股份有限公司	山水比德
江西沐邦高科股份有限公司	沐邦高科
彩讯科技股份有限公司	彩讯股份
长沙通程控股股份有限公司	通程控股
江西赣能股份有限公司	赣能股份
中国三峡新能源集团股份有限公司	三峡能源
温州意华接插件股份有限公司	意华股份
江苏艾迪药业股份有限公司	艾迪药业
苏州晶方半导体科技股份有限公司	晶方科技
银江技术股份有限公司	银江技术
成都天奥电子股份有限公司	天奥电子
国家电投集团产融控股股份有限公司	电投产融
深圳市桑达实业股份有限公司	深桑达
翱捷科技股份有限公司	翱捷科技
蓝盾信息安全技术股份有限公司	蓝盾股份
天津天保基建股份有限公司	天保基建
江中药业股份有限公司	江中药业
深圳麦格米特电气股份有限公司	麦格米特
迪阿股份有限公司	迪阿股份
江苏爱朋医疗科技股份有限公司	爱朋医疗
深圳市汇顶科技股份有限公司	汇顶科技
安徽神剑新材料股份有限公司	神剑股份
深圳市正弦电气股份有限公司	正弦电气
杭州正强传动股份有限公司	正强股份
厦门金龙汽车集团股份有限公司	金龙汽车
北京神州细胞生物技术集团股份公司	神州细胞
广东好太太科技集团股份有限公司	好太太
宋都基业投资股份有限公司	宋都股份
云南云天化股份有限公司	云天化
拓维信息系统股份有限公司	拓维信息
广东德联集团股份有限公司	德联集团
杭州中泰深冷技术股份有限公司	中泰股份
重庆博腾制药科技股份有限公司	博腾股份
大连美吉姆教育科技股份有限公司	美吉姆
深圳市铂科新材料股份有限公司	铂科新材
福建省闽发铝业股份有限公司	闽发铝业
宁波均胜电子股份有限公司	均胜电子
北京合纵科技股份有限公司	合纵科技
恒泰艾普集团股份有限公司	恒泰艾普
美盈森集团股份有限公司	美盈森
东来涂料技术上海股份有限公司	东来技术
四川合纵药易购医药股份有限公司	药易购
浙江瀚叶股份有限公司	瀚叶股份
东睦新材料集团股份有限公司	东睦股份
上海第一医药股份有限公司	第一医药
湖南华升股份有限公司	华升股份
国电电力发展股份有限公司	国电电力
袁隆平农业高科技股份有限公司	隆平高科
佛山电器照明股份有限公司	佛山照明
江苏利通电子股份有限公司	利通电子
中新苏州工业园区开发集团股份有限公司	中新集团
凌源钢铁股份有限公司	凌钢股份
津药达仁堂集团股份有限公司	达仁堂
深圳市中装建设集团股份有限公司	中装建设
北京中关村科技发展控股股份有限公司	中关村
神雾节能股份有限公司	神雾节能
晶瑞电子材料股份有限公司	晶瑞电材
上海冠龙阀门节能设备股份有限公司	冠龙节能
山东山大鸥玛软件股份有限公司	鸥玛软件
国投资本股份有限公司	国投资本
深圳市宝明科技股份有限公司	宝明科技
中信泰富特钢集团股份有限公司	中信特钢
深圳市新城市规划建筑设计股份有限公司	新城市
河南通达电缆股份有限公司	通达股份
新亚强硅化学股份有限公司	新亚强
山东宏创铝业控股股份有限公司	宏创控股
山东先达农化股份有限公司	先达股份
诚迈科技南京股份有限公司	诚迈科技
江苏传智播客教育科技股份有限公司	传智教育
上海绿庭投资控股集团股份有限公司	绿庭投资
深圳市同为数码科技股份有限公司	同为股份
宁波太平鸟时尚服饰股份有限公司	太平鸟
崇义章源钨业股份有限公司	章源钨业
深圳市崧盛电子股份有限公司	崧盛股份
青岛惠城环保科技集团股份有限公司	惠城环保
深圳市隆利科技股份有限公司	隆利科技
辽宁成大生物股份有限公司	成大生物
上海华铭智能终端设备股份有限公司	华铭智能
宁波长阳科技股份有限公司	长阳科技
哈尔滨东安汽车动力股份有限公司	东安动力
万向德农股份有限公司	万向德农
读客文化股份有限公司	读客文化
欢瑞世纪联合股份有限公司	欢瑞世纪
浙江菲达环保科技股份有限公司	菲达环保
厦门唯科模塑科技股份有限公司	唯科科技
苏州赛腾精密电子股份有限公司	赛腾股份
浙江台华新材料股份有限公司	台华新材
威龙葡萄酒股份有限公司	威龙股份
南京康尼机电股份有限公司	康尼机电
海天水务集团股份公司	海天股份
唐山港集团股份有限公司	唐山港
新天绿色能源股份有限公司	新天绿能
苏州苏试试验集团股份有限公司	苏试试验
湖北振华化学股份有限公司	振华股份
厦门特宝生物工程股份有限公司	特宝生物
宜华生活科技股份有限公司	宜华生活
北京海量数据技术股份有限公司	海量数据
深圳达实智能股份有限公司	达实智能
凯瑞德控股股份有限公司	凯瑞德
利亚德光电股份有限公司	利亚德
广州市品高软件股份有限公司	品高软件
格力地产股份有限公司	格力地产
中国船舶重工集团海洋防务与信息对抗股份有限公司	中国海防
苏州市建筑科学研究院集团股份有限公司	建研院
开滦能源化工股份有限公司	开滦股份
欣旺达电子股份有限公司	欣旺达
辽宁何氏眼科医院集团股份有限公司	何氏眼科
深圳市英唐智能控制股份有限公司	英唐智控
浙江东晶电子股份有限公司	东晶电子
成都雷电微力科技股份有限公司	雷电微力
天津鹏翎集团股份有限公司	鹏翎股份
安阳钢铁股份有限公司	安阳钢铁
广东舜喆集团股份有限公司	舜喆B
广东汕头超声电子股份有限公司	超声电子
浙江跃岭股份有限公司	跃岭股份
厦门狄耐克智能科技股份有限公司	狄耐克
浙江东尼电子股份有限公司	东尼电子
江西洪都航空工业股份有限公司	洪都航空
江苏新泉汽车饰件股份有限公司	新泉股份
诚达药业股份有限公司	诚达药业
上海元祖梦果子股份有限公司	元祖股份
襄阳长源东谷实业股份有限公司	长源东谷
苏州斯莱克精密设备股份有限公司	斯莱克
万向新元科技股份有限公司	新元科技
江苏澳洋健康产业股份有限公司	澳洋健康
北京碧水源科技股份有限公司	碧水源
辽宁福鞍重工股份有限公司	福鞍股份
石家庄常山北明科技股份有限公司	常山北明
广东广州日报传媒股份有限公司	粤传媒
北京天智航医疗科技股份有限公司	天智航
天臣国际医疗科技股份有限公司	天臣医疗
长沙银行股份有限公司	长沙银行
浙报数字文化集团股份有限公司	浙数文化
可孚医疗科技股份有限公司	可孚医疗
海利尔药业集团股份有限公司	海利尔
广西桂东电力股份有限公司	桂东电力
国邦医药集团股份有限公司	国邦医药
紫光国芯微电子股份有限公司	紫光国微
中国船舶工业股份有限公司	中国船舶
福建纳川管材科技股份有限公司	纳川股份
创新新材料科技股份有限公司	创新新材
深圳市信维通信股份有限公司	信维通信
无锡华东重型机械股份有限公司	华东重机
上海昊海生物科技股份有限公司	昊海生科
南京港股份有限公司	南京港
湖南景峰医药股份有限公司	景峰医药
中持水务股份有限公司	中持股份
新疆雪峰科技集团股份有限公司	雪峰科技
上海泰坦科技股份有限公司	泰坦科技
北京科锐国际人力资源股份有限公司	科锐国际
乐山电力股份有限公司	乐山电力
上海交大昂立股份有限公司	交大昂立
华仁药业股份有限公司	华仁药业
金健米业股份有限公司	金健米业
广东英联包装股份有限公司	英联股份
瑞纳智能设备股份有限公司	瑞纳智能
上海畅联国际物流股份有限公司	畅联股份
北京城建投资发展股份有限公司	城建发展
山东玉龙黄金股份有限公司	玉龙股份
山东同大海岛新材料股份有限公司	同大股份
广州御银科技股份有限公司	御银股份
山东龙大美食股份有限公司	龙大美食
大商股份有限公司	大商股份
深圳市天健集团股份有限公司	天健集团
山东如意毛纺服装集团股份有限公司	如意集团
深圳莱宝高科技股份有限公司	莱宝高科
胜宏科技惠州股份有限公司	胜宏科技
鲁信创业投资集团股份有限公司	鲁信创投
顾地科技股份有限公司	顾地科技
中航航空高科技股份有限公司	中航高科
光明房地产集团股份有限公司	光明地产
贵州省广播电视信息网络股份有限公司	贵广网络
深圳中富电路股份有限公司	中富电路
江苏中信博新能源科技股份有限公司	中信博
金冠电气股份有限公司	金冠电气
浙江仙通橡塑股份有限公司	浙江仙通
南京埃斯顿自动化股份有限公司	埃斯顿
浙江华媒控股股份有限公司	华媒控股
广东金明精机股份有限公司	金明精机
中国旅游集团中免股份有限公司	中国中免
广东海印集团股份有限公司	海印股份
环旭电子股份有限公司	环旭电子
泰和新材集团股份有限公司	泰和新材
酒鬼酒股份有限公司	酒鬼酒
南微医学科技股份有限公司	南微医学
三河同飞制冷股份有限公司	同飞股份
贵州黔源电力股份有限公司	黔源电力
广东联泰环保股份有限公司	联泰环保
桂林莱茵生物科技股份有限公司	莱茵生物
金陵华软科技股份有限公司	华软科技
深圳市拓日新能源科技股份有限公司	拓日新能
中国光大银行股份有限公司	光大银行
三七互娱网络科技集团股份有限公司	三七互娱
天津津滨发展股份有限公司	津滨发展
深圳朗特智能控制股份有限公司	朗特智能
唐山三孚硅业股份有限公司	三孚股份
深圳市天威视讯股份有限公司	天威视讯
福建闽东电力股份有限公司	闽东电力
西安三角防务股份有限公司	三角防务
深圳市泛海统联精密制造股份有限公司	统联精密
上海爱建集团股份有限公司	爱建集团
金能科技股份有限公司	金能科技
丝路视觉科技股份有限公司	丝路视觉
浙江大立科技股份有限公司	大立科技
任子行网络技术股份有限公司	任子行
福龙马集团股份有限公司	福龙马
嘉兴斯达半导体股份有限公司	斯达半导
摩登大道时尚集团股份有限公司	摩登大道
福建金森林业股份有限公司	福建金森
杭州星帅尔电器股份有限公司	星帅尔
华数传媒控股股份有限公司	华数传媒
有研粉末新材料股份有限公司	有研粉材
江苏阳光股份有限公司	江苏阳光
上海海顺新型药用包装材料股份有限公司	海顺新材
达刚控股集团股份有限公司	达刚控股
昆吾九鼎投资控股股份有限公司	九鼎投资
哈尔滨誉衡药业股份有限公司	誉衡药业
河南辉煌科技股份有限公司	辉煌科技
申通快递股份有限公司	申通快递
沈阳新松机器人自动化股份有限公司	机器人
汉马科技集团股份有限公司	汉马科技
哈尔滨新光光电科技股份有限公司	新光光电
广东宝丽华新能源股份有限公司	宝新能源
上海飞乐音响股份有限公司	飞乐音响
中国联合网络通信股份有限公司	中国联通
北京龙软科技股份有限公司	龙软科技
北京盈建科软件股份有限公司	盈建科
张小泉股份有限公司	张小泉
上海兰卫医学检验所股份有限公司	兰卫医学
北京银行股份有限公司	北京银行
大参林医药集团股份有限公司	大参林
浙江天正电气股份有限公司	天正电气
江苏飞力达国际物流股份有限公司	飞力达
金字火腿股份有限公司	金字火腿
江苏蓝丰生物化工股份有限公司	蓝丰生化
亿嘉和科技股份有限公司	亿嘉和
新奥天然气股份有限公司	新奥股份
天津汽车模具股份有限公司	天汽模
辰欣药业股份有限公司	辰欣药业
西安晨曦航空科技股份有限公司	晨曦航空
金华春光橡塑科技股份有限公司	春光科技
广东锦龙发展股份有限公司	锦龙股份
数源科技股份有限公司	数源科技
南宁糖业股份有限公司	南宁糖业
北京菜市口百货股份有限公司	菜百股份
联化科技股份有限公司	联化科技
中原大地传媒股份有限公司	中原传媒
苏州世华新材料科技股份有限公司	世华科技
深圳微芯生物科技股份有限公司	微芯生物
江苏辉丰生物农业股份有限公司	辉丰股份
四川省新能源动力股份有限公司	川能动力
成都佳发安泰教育科技股份有限公司	佳发教育
际华集团股份有限公司	际华集团
奇安信科技集团股份有限公司	奇安信
湖南华菱线缆股份有限公司	华菱线缆
智洋创新科技股份有限公司	智洋创新
兰州长城电工股份有限公司	长城电工
兰剑智能科技股份有限公司	兰剑智能
东兴证券股份有限公司	东兴证券
深圳震有科技股份有限公司	震有科技
江苏太平洋精锻科技股份有限公司	精锻科技
众应互联科技股份有限公司	众应互联
诚邦生态环境股份有限公司	诚邦股份
四川川润股份有限公司	川润股份
深圳市赛为智能股份有限公司	赛为智能
江苏浩欧博生物医药股份有限公司	浩欧博
马应龙药业集团股份有限公司	马应龙
上海科泰电源股份有限公司	科泰电源
日照港股份有限公司	日照港
西藏华钰矿业股份有限公司	华钰矿业
中节能万润股份有限公司	万润股份
歌尔股份有限公司	歌尔股份
浙江金固股份有限公司	金固股份
金现代信息产业股份有限公司	金现代
广东电力发展股份有限公司	粤电力
深圳市海普瑞药业集团股份有限公司	海普瑞
上海风语筑文化科技股份有限公司	风语筑
贵阳朗玛信息技术股份有限公司	朗玛信息
沙河实业股份有限公司	沙河股份
江西富祥药业股份有限公司	富祥药业
威腾电气集团股份有限公司	威腾电气
南京音飞储存设备集团股份有限公司	音飞储存
浙江东日股份有限公司	浙江东日
成都康弘药业集团股份有限公司	康弘药业
江西国泰集团股份有限公司	国泰集团
北京同仁堂股份有限公司	同仁堂
湖南百利工程科技股份有限公司	百利科技
江山欧派门业股份有限公司	江山欧派
四川蓝光发展股份有限公司	蓝光发展
苏州龙杰特种纤维股份有限公司	苏州龙杰
深圳市飞马国际供应链股份有限公司	飞马国际
长春致远新能源装备股份有限公司	致远新能
众泰汽车股份有限公司	众泰汽车
美尚生态景观股份有限公司	美尚生态
江苏海晨物流股份有限公司	海晨股份
大唐华银电力股份有限公司	华银电力
科博达技术股份有限公司	科博达
浙江盛泰服装集团股份有限公司	盛泰集团
大连电瓷集团股份有限公司	大连电瓷
广州维力医疗器械股份有限公司	维力医疗
山东太阳纸业股份有限公司	太阳纸业
浙江核新同花顺网络信息股份有限公司	同花顺
广州市浪奇实业股份有限公司	广州浪奇
北京思特奇信息技术股份有限公司	思特奇
青海互助天佑德青稞酒股份有限公司	天佑德酒
江苏亚星锚链股份有限公司	亚星锚链
深圳赫美集团股份有限公司	赫美集团
青岛国恩科技股份有限公司	国恩股份
珠海华发实业股份有限公司	华发股份
浙江世宝股份有限公司	浙江世宝
海南葫芦娃药业集团股份有限公司	葫芦娃
贵阳新天药业股份有限公司	新天药业
山东赛托生物科技股份有限公司	赛托生物
探路者控股集团股份有限公司	探路者
国盛金融控股集团股份有限公司	国盛金控
深圳市倍轻松科技股份有限公司	倍轻松
湖南三德科技股份有限公司	三德科技
浙江棒杰控股集团股份有限公司	棒杰股份
大众交通集团股份有限公司	大众交通
南京云海特种金属股份有限公司	云海金属
孩子王儿童用品股份有限公司	孩子王
中钨高新材料股份有限公司	中钨高新
中源协和细胞基因工程股份有限公司	中源协和
东芯半导体股份有限公司	东芯股份
嘉寓控股股份公司	嘉寓股份
江苏华西村股份有限公司	华西股份
重庆宗申动力机械股份有限公司	宗申动力
广州珠江啤酒股份有限公司	珠江啤酒
山东中农联合生物科技股份有限公司	中农联合
陕西航天动力高科技股份有限公司	航天动力
深圳市安奈儿股份有限公司	安奈儿
广东溢多利生物科技股份有限公司	溢多利
国机通用机械科技股份有限公司	国机通用
兴源环境科技股份有限公司	兴源环境
上海城地香江数据科技股份有限公司	城地香江
北京交大思诺科技股份有限公司	交大思诺
北京市大龙伟业房地产开发股份有限公司	大龙地产
宁波GQY视讯股份有限公司	GQY视讯
北京万集科技股份有限公司	万集科技
太平洋证券股份有限公司	太平洋
江阴江化微电子材料股份有限公司	江化微
上海开创国际海洋资源股份有限公司	开创国际
中南红文化集团股份有限公司	中南文化
远光软件股份有限公司	远光软件
汉威科技集团股份有限公司	汉威科技
精伦电子股份有限公司	精伦电子
有棵树科技股份有限公司	有棵树
无锡市振华汽车部件股份有限公司	无锡振华
亿阳信通股份有限公司	亿阳信通
福建坤彩材料科技股份有限公司	坤彩科技
江苏汇鸿国际集团股份有限公司	汇鸿集团
广电计量检测集团股份有限公司	广电计量
青岛汇金通电力设备股份有限公司	汇金通
浙江森马服饰股份有限公司	森马服饰
北京万泰生物药业股份有限公司	万泰生物
湖北菲利华石英玻璃股份有限公司	菲利华
上海良信电器股份有限公司	良信股份
浙江三美化工股份有限公司	三美股份
招商局积余产业运营服务股份有限公司	招商积余
北京高能时代环境技术股份有限公司	高能环境
上海振华重工集团股份有限公司	振华重工
哈尔滨三联药业股份有限公司	哈三联
中微半导体设备上海股份有限公司	中微公司
常州银河世纪微电子股份有限公司	银河微电
湖南郴电国际发展股份有限公司	郴电国际
安徽华尔泰化工股份有限公司	华尔泰
北京石头世纪科技股份有限公司	石头科技
深圳市铭利达精密技术股份有限公司	铭利达
合盛硅业股份有限公司	合盛硅业
宝泰隆新材料股份有限公司	宝泰隆
山推工程机械股份有限公司	山推股份
宏润建设集团股份有限公司	宏润建设
昆山科森科技股份有限公司	科森科技
宁波拓普集团股份有限公司	拓普集团
广东世运电路科技股份有限公司	世运电路
杭州先锋电子技术股份有限公司	先锋电子
亚翔系统集成科技苏州股份有限公司	亚翔集成
圣元环保股份有限公司	圣元环保
天津利安隆新材料股份有限公司	利安隆
深圳欣锐科技股份有限公司	欣锐科技
北京竞业达数码科技股份有限公司	竞业达
上海雅仕投资发展股份有限公司	上海雅仕
上海新动力汽车科技股份有限公司	动力新科
宁波鲍斯能源装备股份有限公司	鲍斯股份
东方通信股份有限公司	东方通信
青岛金王应用化学股份有限公司	青岛金王
梅花生物科技集团股份有限公司	梅花生物
烟台张裕葡萄酿酒股份有限公司	张裕
桂林西麦食品股份有限公司	西麦食品
上海数据港股份有限公司	数据港
兴业银行股份有限公司	兴业银行
中芯国际集成电路制造有限公司	中芯国际
申能股份有限公司	申能股份
华塑控股股份有限公司	华塑控股
常州市凯迪电器股份有限公司	凯迪股份
中集车辆集团股份有限公司	中集车辆
常州天晟新材料股份有限公司	天晟新材
新疆塔里木农业综合开发股份有限公司	新农开发
圣湘生物科技股份有限公司	圣湘生物
福建浔兴拉链科技股份有限公司	浔兴股份
上海科华生物工程股份有限公司	科华生物
雅本化学股份有限公司	雅本化学
金宏气体股份有限公司	金宏气体
浙江海利得新材料股份有限公司	海利得
青岛日辰食品股份有限公司	日辰股份
江苏鼎胜新能源材料股份有限公司	鼎胜新材
佩蒂动物营养科技股份有限公司	佩蒂股份
宝塔实业股份有限公司	宝塔实业
华电能源股份有限公司	华电能源
科大讯飞股份有限公司	科大讯飞
永兴特种材料科技股份有限公司	永兴材料
西藏易明西雅医药科技股份有限公司	易明医药
西南证券股份有限公司	西南证券
同方股份有限公司	同方股份
苏州东山精密制造股份有限公司	东山精密
湖北回天新材料股份有限公司	回天新材
星光农机股份有限公司	星光农机
水发派思燃气股份有限公司	水发燃气
福莱特玻璃集团股份有限公司	福莱特
江苏长龄液压股份有限公司	长龄液压
浙江花园生物医药股份有限公司	花园生物
安徽长城军工股份有限公司	长城军工
横店集团东磁股份有限公司	横店东磁
黄石东贝电器股份有限公司	东贝电器
深圳市和科达精密清洗设备股份有限公司	和科达
天润工业技术股份有限公司	天润工业
广东海川智能机器股份有限公司	海川智能
国投电力控股股份有限公司	国投电力
上海翔港包装科技股份有限公司	翔港科技
锦浪科技股份有限公司	锦浪科技
深圳万润科技股份有限公司	万润科技
上海益民商业集团股份有限公司	益民集团
北京宇信科技集团股份有限公司	宇信科技
广东省高速公路发展股份有限公司	粤高速
江西日月明测控科技股份有限公司	日月明
宁波慈星股份有限公司	慈星股份
江苏悦达投资股份有限公司	悦达投资
大连圣亚旅游控股股份有限公司	大连圣亚
北京煜邦电力技术股份有限公司	煜邦电力
上海创力集团股份有限公司	创力集团
迪安诊断技术集团股份有限公司	迪安诊断
深圳市芭田生态工程股份有限公司	芭田股份
北海银河生物产业投资股份有限公司	银河生物
三羊马重庆物流股份有限公司	三羊马
上海安硕信息技术股份有限公司	安硕信息
江苏天瑞仪器股份有限公司	天瑞仪器
湖北三峡旅游集团股份有限公司	三峡旅游
福建水泥股份有限公司	福建水泥
浪潮电子信息产业股份有限公司	浪潮信息
浙江浙能电力股份有限公司	浙能电力
万控智造股份有限公司	万控智造
深圳王子新材料股份有限公司	王子新材
奇精机械股份有限公司	奇精机械
庞大汽贸集团股份有限公司	庞大集团
深圳欧陆通电子股份有限公司	欧陆通
厦门厦钨新能源材料股份有限公司	厦钨新能
沈阳萃华金银珠宝股份有限公司	萃华珠宝
北京铁科首钢轨道技术股份有限公司	铁科轨道
国民技术股份有限公司	国民技术
雪松发展股份有限公司	雪松发展
江苏金融租赁股份有限公司	江苏金租
山东威高骨科材料股份有限公司	威高骨科
永安期货股份有限公司	永安期货
广州珠江发展集团股份有限公司	珠江股份
南通江天化学股份有限公司	江天化学
高升控股股份有限公司	高升控股
江苏立霸实业股份有限公司	立霸股份
佛山市金银河智能装备股份有限公司	金银河
上海加冷松芝汽车空调股份有限公司	松芝股份
深圳四方精创资讯股份有限公司	四方精创
良品铺子股份有限公司	良品铺子
东风汽车股份有限公司	东风汽车
苏州新区高新技术产业股份有限公司	苏州高新
中粮糖业控股股份有限公司	中粮糖业
深圳市金溢科技股份有限公司	金溢科技
中国北方稀土集团高科技股份有限公司	北方稀土
浙江嘉益保温科技股份有限公司	嘉益股份
北京掌趣科技股份有限公司	掌趣科技
深圳市法本信息技术股份有限公司	法本信息
浙江争光实业股份有限公司	争光股份
唐山冀东水泥股份有限公司	冀东水泥
上海国际机场股份有限公司	上海机场
广州达安基因股份有限公司	达安基因
科大智能科技股份有限公司	科大智能
宁波永新光学股份有限公司	永新光学
黑龙江珍宝岛药业股份有限公司	珍宝岛
长江精工钢结构集团股份有限公司	精工钢构
上海卓然工程技术股份有限公司	卓然股份
力帆科技集团股份有限公司	力帆科技
神思电子技术股份有限公司	神思电子
中钢天源股份有限公司	中钢天源
江苏日盈电子股份有限公司	日盈电子
广东利元亨智能装备股份有限公司	利元亨
上海复旦微电子集团股份有限公司	复旦微电
厦门华侨电子股份有限公司	厦华电子
包头华资实业股份有限公司	华资实业
浙江华正新材料股份有限公司	华正新材
海宁中国皮革城股份有限公司	海宁皮城
杭州安旭生物科技股份有限公司	安旭生物
经纬纺织机械股份有限公司	经纬纺机
福建福能股份有限公司	福能股份
怀集登云汽配股份有限公司	登云股份
通鼎互联信息股份有限公司	通鼎互联
中国软件与技术服务股份有限公司	中国软件
红相股份有限公司	红相股份
西藏城市发展投资股份有限公司	西藏城投
上海姚记科技股份有限公司	姚记科技
苏州兴业材料科技股份有限公司	兴业股份
西藏矿业发展股份有限公司	西藏矿业
北京北摩高科摩擦材料股份有限公司	北摩高科
中通国脉通信股份有限公司	中通国脉
深圳市科思科技股份有限公司	科思科技
中房置业股份有限公司	中房股份
大恒新纪元科技股份有限公司	大恒科技
山东得利斯食品股份有限公司	得利斯
顺丰控股股份有限公司	顺丰控股
江苏澄星磷化工股份有限公司	澄星股份
广东雪莱特光电科技股份有限公司	雪莱特
苏州麦迪斯顿医疗科技股份有限公司	麦迪科技
恒锋工具股份有限公司	恒锋工具
浙江华是科技股份有限公司	华是科技
浙江亚太机电股份有限公司	亚太股份
浙江康恩贝制药股份有限公司	康恩贝
银座集团股份有限公司	银座股份
中国东方红卫星股份有限公司	中国卫星
惠州市华阳集团股份有限公司	华阳集团
中国化学工程股份有限公司	中国化学
安徽皖通科技股份有限公司	皖通科技
苏州银行股份有限公司	苏州银行
广州洁特生物过滤股份有限公司	洁特生物
浙江晶盛机电股份有限公司	晶盛机电
广东塔牌集团股份有限公司	塔牌集团
地素时尚股份有限公司	地素时尚
鹏都农牧股份有限公司	鹏都农牧
广东高乐股份有限公司	高乐股份
广州中望龙腾软件股份有限公司	中望软件
宁波德昌电机股份有限公司	德昌股份
德尔未来科技控股集团股份有限公司	德尔未来
福建发展高速公路股份有限公司	福建高速
南通醋酸化工股份有限公司	醋化股份
北京易华录信息技术股份有限公司	易华录
安徽黄山胶囊股份有限公司	黄山胶囊
浙江长城电工科技股份有限公司	长城科技
河南中孚实业股份有限公司	中孚实业
上海豫园旅游商城集团股份有限公司	豫园股份
华设设计集团股份有限公司	华设集团
天洋新材上海科技股份有限公司	天洋新材
每日互动股份有限公司	每日互动
渤海轮渡集团股份有限公司	渤海轮渡
康佳集团股份有限公司	深康佳
厦门乾照光电股份有限公司	乾照光电
安徽壹石通材料科技股份有限公司	壹石通
兰州庄园牧场股份有限公司	庄园牧场
广东久量股份有限公司	久量股份
开能健康科技集团股份有限公司	开能健康
中山大洋电机股份有限公司	大洋电机
深圳光韵达光电科技股份有限公司	光韵达
杭州巨星科技股份有限公司	巨星科技
利群商业集团股份有限公司	利群股份
深圳市农产品集团股份有限公司	农产品
广东顺钠电气股份有限公司	顺钠股份
江苏博信投资控股股份有限公司	博信股份
北京四方继保自动化股份有限公司	四方股份
濮阳濮耐高温材料集团股份有限公司	濮耐股份
青岛城市传媒股份有限公司	城市传媒
新疆浩源天然气股份有限公司	新疆浩源
新疆众和股份有限公司	新疆众和
实朴检测技术上海股份有限公司	实朴检测
海航科技股份有限公司	海航科技
深圳市燃气集团股份有限公司	深圳燃气
浙江新和成股份有限公司	新和成
陕西莱特光电材料股份有限公司	莱特光电
上海新黄浦实业集团股份有限公司	新黄浦
上海新文化传媒集团股份有限公司	新文化
果麦文化传媒股份有限公司	果麦文化
郑州安图生物工程股份有限公司	安图生物
苏州迈为科技股份有限公司	迈为股份
创业黑马科技集团股份有限公司	创业黑马
福建雪人股份有限公司	雪人股份
神州数码集团股份有限公司	神州数码
北京金山办公软件股份有限公司	金山办公
阳煤化工股份有限公司	阳煤化工
浪潮软件股份有限公司	浪潮软件
宋城演艺发展股份有限公司	宋城演艺
思源电气股份有限公司	思源电气
三变科技股份有限公司	三变科技
厦门安妮股份有限公司	安妮股份
博众精工科技股份有限公司	博众精工
青岛海容商用冷链股份有限公司	海容冷链
浙江九洲药业股份有限公司	九洲药业
陕西煤业股份有限公司	陕西煤业
家家悦集团股份有限公司	家家悦
宁夏银星能源股份有限公司	银星能源
浙江铁流离合器股份有限公司	铁流股份
武汉当代明诚文化体育集团股份有限公司	当代文体
大化集团大连化工股份有限公司	大化股份
润建股份有限公司	润建股份
杭州汽轮动力集团股份有限公司	杭汽轮
成都银行股份有限公司	成都银行
安徽楚江科技新材料股份有限公司	楚江新材
深圳冰川网络股份有限公司	冰川网络
浙江钱江生物化学股份有限公司	钱江生化
TCL中环新能源科技股份有限公司	TCL中环
江苏硕世生物科技股份有限公司	硕世生物
广东通宇通讯股份有限公司	通宇通讯
深圳市新产业生物医学工程股份有限公司	新产业
深圳市明微电子股份有限公司	明微电子
江苏通用科技股份有限公司	通用股份
金花企业集团股份有限公司	金花股份
福建三木集团股份有限公司	三木集团
芯海科技深圳股份有限公司	芯海科技
万兴科技集团股份有限公司	万兴科技
南京纺织品进出口股份有限公司	南纺股份
江苏吉贝尔药业股份有限公司	吉贝尔
广州华立科技股份有限公司	华立科技
众信旅游集团股份有限公司	众信旅游
泰瑞机器股份有限公司	泰瑞机器
杰克科技股份有限公司	杰克股份
上海金桥信息股份有限公司	金桥信息
国新文化控股股份有限公司	国新文化
杭州申昊科技股份有限公司	申昊科技
福建紫天传媒科技股份有限公司	紫天科技
合兴汽车电子股份有限公司	合兴股份
南京海辰药业股份有限公司	海辰药业
新疆合金投资股份有限公司	合金投资
贵州三力制药股份有限公司	贵州三力
宁波舟山港股份有限公司	宁波港
天壕环境股份有限公司	天壕环境
成都市路桥工程股份有限公司	成都路桥
深圳市得润电子股份有限公司	得润电子
无锡商业大厦大东方股份有限公司	大东方
深圳高速公路集团股份有限公司	深高速
义乌华鼎锦纶股份有限公司	华鼎股份
启迪设计集团股份有限公司	启迪设计
江苏紫金农村商业银行股份有限公司	紫金银行
深圳市振邦智能科技股份有限公司	振邦智能
威海广泰空港设备股份有限公司	威海广泰
汉嘉设计集团股份有限公司	汉嘉设计
新风光电子科技股份有限公司	新风光
珠海博杰电子股份有限公司	博杰股份
深圳市易瑞生物技术股份有限公司	易瑞生物
科威尔技术股份有限公司	科威尔
深圳市方直科技股份有限公司	方直科技
北京市博汇科技股份有限公司	博汇科技
浙江恒威电池股份有限公司	浙江恒威
科华控股股份有限公司	科华控股
广东纬德信息科技股份有限公司	纬德信息
维科技术股份有限公司	维科技术
南华生物医药股份有限公司	南华生物
成都高新发展股份有限公司	高新发展
华昌达智能装备集团股份有限公司	华昌达
山东步长制药股份有限公司	步长制药
上海皓元医药股份有限公司	皓元医药
中公教育科技股份有限公司	中公教育
湖南华联瓷业股份有限公司	华瓷股份
超捷紧固系统上海股份有限公司	超捷股份
鲁泰纺织股份有限公司	鲁泰纺织
鲁银投资集团股份有限公司	鲁银投资
上海剑桥科技股份有限公司	剑桥科技
河北华通线缆集团股份有限公司	华通线缆
河南银鸽实业投资股份有限公司	银鸽投资
铁岭新城投资控股集团股份有限公司	铁岭新城
隆基绿能科技股份有限公司	隆基绿能
苏州苏大维格科技集团股份有限公司	苏大维格
南京栖霞建设股份有限公司	栖霞建设
北京元六鸿远电子科技股份有限公司	鸿远电子
有研新材料股份有限公司	有研新材
汕头万顺新材集团股份有限公司	万顺新材
山东玲珑轮胎股份有限公司	玲珑轮胎
供销大集集团股份有限公司	供销大集
中船海洋与防务装备股份有限公司	中船防务
大理药业股份有限公司	大理药业
惠州光弘科技股份有限公司	光弘科技
龙星化工股份有限公司	龙星化工
华致酒行连锁管理股份有限公司	华致酒行
美格智能技术股份有限公司	美格智能
京北方信息技术股份有限公司	京北方
宁波富达股份有限公司	宁波富达
浙江严牌过滤技术股份有限公司	严牌股份
益丰大药房连锁股份有限公司	益丰药房
赤峰吉隆黄金矿业股份有限公司	赤峰黄金
信雅达科技股份有限公司	信雅达
立达信物联科技股份有限公司	立达信
龙洲集团股份有限公司	龙洲股份
盐津铺子食品股份有限公司	盐津铺子
奥锐特药业股份有限公司	奥锐特
武汉精测电子集团股份有限公司	精测电子
浙江金海高科股份有限公司	金海高科
秦皇岛港股份有限公司	秦港股份
江苏中设集团股份有限公司	中设股份
深圳市瑞凌实业集团股份有限公司	瑞凌股份
北京万通新发展集团股份有限公司	万通发展
江苏神通阀门股份有限公司	江苏神通
长飞光纤光缆股份有限公司	长飞光纤
中国铁路通信信号股份有限公司	中国通号
深圳奥雅设计股份有限公司	奥雅股份
金卡智能集团股份有限公司	金卡智能
浙江新化化工股份有限公司	新化股份
西安瑞联新材料股份有限公司	瑞联新材
广东紫晶信息存储技术股份有限公司	紫晶存储
江苏怡达化学股份有限公司	怡达股份
四川发展龙蟒股份有限公司	川发龙蟒
天水众兴菌业科技股份有限公司	众兴菌业
浙江奥翔药业股份有限公司	奥翔药业
金宇生物技术股份有限公司	生物股份
安徽辉隆农资集团股份有限公司	辉隆股份
北京飞利信科技股份有限公司	飞利信
深圳普门科技股份有限公司	普门科技
三六零安全科技股份有限公司	三六零
宁波喜悦智行科技股份有限公司	喜悦智行
东方航空物流股份有限公司	东航物流
江苏新瀚新材料股份有限公司	新瀚新材
华夏幸福基业股份有限公司	华夏幸福
中成进出口股份有限公司	中成股份
山东金岭矿业股份有限公司	金岭矿业
朗源股份有限公司	朗源股份
浙江德创环保科技股份有限公司	德创环保
新疆天业股份有限公司	新疆天业
北京正和恒基滨水生态环境治理股份有限公司	正和生态
新国脉数字文化股份有限公司	国脉文化
江苏金陵体育器材股份有限公司	金陵体育
中国航发航空科技股份有限公司	航发科技
北京盛通印刷股份有限公司	盛通股份
潍坊亚星化学股份有限公司	亚星化学
金利华电气股份有限公司	金利华电
游族网络股份有限公司	游族网络
成都先导药物开发股份有限公司	成都先导
鼎龙文化股份有限公司	鼎龙文化
浙江泰林生物技术股份有限公司	泰林生物
浙江精工集成科技股份有限公司	精工科技
成都坤恒顺维科技股份有限公司	坤恒顺维
杭州鸿泉物联网技术股份有限公司	鸿泉物联
浙江众合科技股份有限公司	众合科技
上海悦心健康集团股份有限公司	悦心健康
中国高科集团股份有限公司	中国高科
明阳智慧能源集团股份公司	明阳智能
广汇汽车服务集团股份公司	广汇汽车
沈阳商业城股份有限公司	商业城
华蓝集团股份公司	华蓝集团
广东榕泰实业股份有限公司	广东榕泰
深圳市华盛昌科技实业股份有限公司	华盛昌
上海大智慧股份有限公司	大智慧
苏州工业园区凌志软件股份有限公司	凌志软件
山东阳谷华泰化工股份有限公司	阳谷华泰
江苏恒顺醋业股份有限公司	恒顺醋业
云南白药集团股份有限公司	云南白药
杭州联络互动信息科技股份有限公司	联络互动
飞亚达精密科技股份有限公司	飞亚达
南极电商股份有限公司	南极电商
上海浦东建设股份有限公司	浦东建设
南京新联电子股份有限公司	新联电子
深圳瑞捷工程咨询股份有限公司	深圳瑞捷
深圳市金奥博科技股份有限公司	金奥博
山东龙泉管道工程股份有限公司	龙泉股份
贵州永吉印务股份有限公司	永吉股份
中国出版传媒股份有限公司	中国出版
中国石油集团资本股份有限公司	中油资本
盛屯矿业集团股份有限公司	盛屯矿业
中源家居股份有限公司	中源家居
江西新余国科科技股份有限公司	新余国科
深圳诺普信农化股份有限公司	诺普信
福建龙溪轴承集团股份有限公司	龙溪股份
江苏联测机电科技股份有限公司	联测科技
欧普照明股份有限公司	欧普照明
西藏发展股份有限公司	西藏发展
许继电气股份有限公司	许继电气
华能国际电力股份有限公司	华能国际
健帆生物科技集团股份有限公司	健帆生物
温州市冠盛汽车零部件集团股份有限公司	冠盛股份
上海硅产业集团股份有限公司	沪硅产业
北京科蓝软件系统股份有限公司	科蓝软件
北京旋极信息技术股份有限公司	旋极信息
浙江比依电器股份有限公司	比依股份
浙江运达风电股份有限公司	运达股份
深圳市城市交通规划设计研究中心股份有限公司	深城交
江阴海达橡塑股份有限公司	海达股份
宁波华翔电子股份有限公司	宁波华翔
佳缘科技股份有限公司	佳缘科技
仲景食品股份有限公司	仲景食品
中银国际证券股份有限公司	中银证券
江苏捷捷微电子股份有限公司	捷捷微电
福建恒而达新材料股份有限公司	恒而达
江苏洛凯机电股份有限公司	洛凯股份
深圳市星源材质科技股份有限公司	星源材质
孚日集团股份有限公司	孚日股份
保利联合化工控股集团股份有限公司	保利联合
上海城投控股股份有限公司	城投控股
浙江华生科技股份有限公司	华生科技
苏宁易购集团股份有限公司	苏宁易购
山东英科环保再生资源股份有限公司	英科再生
华夏银行股份有限公司	华夏银行
雪天盐业集团股份有限公司	雪天盐业
江苏立华牧业股份有限公司	立华股份
木林森股份有限公司	木林森
上海贝岭股份有限公司	上海贝岭
安徽江淮汽车集团股份有限公司	江淮汽车
久祺股份有限公司	久祺股份
浙江南都电源动力股份有限公司	南都电源
湖北省广播电视信息网络股份有限公司	湖北广电
重庆水务集团股份有限公司	重庆水务
伊之密股份有限公司	伊之密
税友软件集团股份有限公司	税友股份
华荣科技股份有限公司	华荣股份
福建东百集团股份有限公司	东百集团
昆明川金诺化工股份有限公司	川金诺
凯盛科技股份有限公司	凯盛科技
三达膜环境技术股份有限公司	三达膜
深圳市民德电子科技股份有限公司	民德电子
重庆百货大楼股份有限公司	重庆百货
长城国际动漫游戏股份有限公司	长城动漫
成都西菱动力科技股份有限公司	西菱动力
恒逸石化股份有限公司	恒逸石化
宁波天龙电子股份有限公司	天龙股份
山东胜利股份有限公司	胜利股份
无锡祥生医疗科技股份有限公司	祥生医疗
湖北和远气体股份有限公司	和远气体
深圳能源集团股份有限公司	深圳能源
中国能源建设股份有限公司	中国能建
金鸿控股集团股份有限公司	金鸿控股
河北金牛化工股份有限公司	金牛化工
包头东宝生物技术股份有限公司	东宝生物
广州三孚新材料科技股份有限公司	三孚新科
康得新复合材料集团股份有限公司	康得新
北京市春立正达医疗器械股份有限公司	春立医疗
河北汇金集团股份有限公司	汇金股份
中文在线集团股份有限公司	中文在线
方大集团股份有限公司	方大集团
法兰泰克重工股份有限公司	法兰泰克
辽宁成大股份有限公司	辽宁成大
安徽应流机电股份有限公司	应流股份
维维食品饮料股份有限公司	维维股份
江苏综艺股份有限公司	综艺股份
苏州金鸿顺汽车部件股份有限公司	金鸿顺
东港股份有限公司	东港股份
盛视科技股份有限公司	盛视科技
广东生益科技股份有限公司	生益科技
大连华锐重工集团股份有限公司	大连重工
内蒙古鄂尔多斯资源股份有限公司	鄂尔多斯
葫芦岛锌业股份有限公司	锌业股份
江苏长青农化股份有限公司	长青股份
荣科科技股份有限公司	荣科科技
贵州轮胎股份有限公司	贵州轮胎
青岛英派斯健康科技股份有限公司	英派斯
峨眉山旅游股份有限公司	峨眉旅游
宁夏建材集团股份有限公司	宁夏建材
普莱柯生物工程股份有限公司	普莱柯
上海安路信息科技股份有限公司	安路科技
北京君正集成电路股份有限公司	北京君正
上海汇得科技股份有限公司	汇得科技
中信海洋直升机股份有限公司	中信海直
四川明星电力股份有限公司	明星电力
浙矿重工股份有限公司	浙矿股份
株洲飞鹿高新材料技术股份有限公司	飞鹿股份
宇通客车股份有限公司	宇通客车
上海锦江国际酒店股份有限公司	锦江酒店
成都立航科技股份有限公司	立航科技
浙江航民股份有限公司	航民股份
湖南汉森制药股份有限公司	汉森制药
广晟有色金属股份有限公司	广晟有色
牧高笛户外用品股份有限公司	牧高笛
上海新通联包装股份有限公司	新通联
易联众信息技术股份有限公司	易联众
中炬高新技术实业集团股份有限公司	中炬高新
浙江富春江环保热电股份有限公司	富春环保
北京东方国信科技股份有限公司	东方国信
南华期货股份有限公司	南华期货
新疆同济堂健康产业股份有限公司	同济堂
稳健医疗用品股份有限公司	稳健医疗
杭州中亚机械股份有限公司	中亚股份
青岛伟隆阀门股份有限公司	伟隆股份
跨境通宝电子商务股份有限公司	跨境通
北京国联视讯信息技术股份有限公司	国联股份
杭州顺网科技股份有限公司	顺网科技
永辉超市股份有限公司	永辉超市
禾丰食品股份有限公司	禾丰股份
青岛海尔生物医疗股份有限公司	海尔生物
泸州老窖股份有限公司	泸州老窖
顺发恒业股份公司	顺发恒业
国睿科技股份有限公司	国睿科技
美瑞新材料股份有限公司	美瑞新材
深圳市路畅科技股份有限公司	路畅科技
深圳市超频三科技股份有限公司	超频三
浙江京新药业股份有限公司	京新药业
广东电声市场营销股份有限公司	电声股份
安通控股股份有限公司	安通控股
八方电气苏州股份有限公司	八方股份
杭州初灵信息技术股份有限公司	初灵信息
伟时电子股份有限公司	伟时电子
航天工业发展股份有限公司	航天发展
杭州凯尔达焊接机器人股份有限公司	凯尔达
四川达威科技股份有限公司	达威股份
梦天家居集团股份有限公司	梦天家居
东莞市宇瞳光学科技股份有限公司	宇瞳光学
安徽安孚电池科技股份有限公司	安孚科技
深圳市同益实业股份有限公司	同益股份
广东凯普生物科技股份有限公司	凯普生物
内蒙古北方重型汽车股份有限公司	北方股份
甘肃国芳工贸集团股份有限公司	国芳集团
内蒙古福瑞医疗科技股份有限公司	福瑞股份
苏州天沃科技股份有限公司	天沃科技
浙江大胜达包装股份有限公司	大胜达
河南凯旺电子科技股份有限公司	凯旺科技
中航航空电子系统股份有限公司	中航电子
上海海立集团股份有限公司	海立股份
深圳市理邦精密仪器股份有限公司	理邦仪器
华兰生物疫苗股份有限公司	华兰疫苗
大连天宝绿色食品股份有限公司	天宝食品
天津市依依卫生用品股份有限公司	依依股份
欣贺股份有限公司	欣贺股份
茂硕电源科技股份有限公司	茂硕电源
蓝星安迪苏股份有限公司	安迪苏
长沙岱勒新材料科技股份有限公司	岱勒新材
成都秦川物联网科技股份有限公司	秦川物联
四会富仕电子科技股份有限公司	四会富仕
湖南国科微电子股份有限公司	国科微
迪瑞医疗科技股份有限公司	迪瑞医疗
安徽省建筑设计研究总院股份有限公司	建研设计
郑州天迈科技股份有限公司	天迈科技
上海亚通股份有限公司	亚通股份
葵花药业集团股份有限公司	葵花药业
华安证券股份有限公司	华安证券
苏州纳微科技股份有限公司	纳微科技
江苏中天科技股份有限公司	中天科技
普冉半导体上海股份有限公司	普冉股份
恒玄科技上海股份有限公司	恒玄科技
湖南天润数字娱乐文化传媒股份有限公司	天润数娱
茂业商业股份有限公司	茂业商业
南京伟思医疗科技股份有限公司	伟思医疗
苏州工业园区和顺电气股份有限公司	和顺电气
卫星化学股份有限公司	卫星化学
深圳市杰普特光电股份有限公司	杰普特
山东新潮能源股份有限公司	新潮能源
迈赫机器人自动化股份有限公司	迈赫股份
中国中车股份有限公司	中国中车
宁波迦南智能电气股份有限公司	迦南智能
中铁高新工业股份有限公司	中铁工业
中天金融集团股份有限公司	中天金融
北京韩建河山管业股份有限公司	韩建河山
湖北双环科技股份有限公司	双环科技
中科创达软件股份有限公司	中科创达
西王食品股份有限公司	西王食品
江苏百川高科新材料股份有限公司	百川股份
浙江凯恩特种材料股份有限公司	凯恩股份
浙江中国轻纺城集团股份有限公司	轻纺城
海马汽车股份有限公司	海马汽车
北京康辰药业股份有限公司	康辰药业
鞍山森远路桥股份有限公司	森远股份
上海徐家汇商城股份有限公司	徐家汇
中国武夷实业股份有限公司	中国武夷
北京晓程科技股份有限公司	晓程科技
浙大网新科技股份有限公司	浙大网新
民生控股股份有限公司	民生控股
无锡航亚科技股份有限公司	航亚科技
山东联科科技股份有限公司	联科科技
深圳市名家汇科技股份有限公司	名家汇
中国振华集团科技股份有限公司	振华科技
北京东方通科技股份有限公司	东方通
上海物资贸易股份有限公司	上海物贸
航天宏图信息技术股份有限公司	航天宏图
德龙汇能集团股份有限公司	德龙汇能
重庆银行股份有限公司	重庆银行
山东雅博科技股份有限公司	雅博股份
浙江盾安人工环境股份有限公司	盾安环境
朗新科技集团股份有限公司	朗新科技
山东国瓷功能材料股份有限公司	国瓷材料
北京同有飞骥科技股份有限公司	同有科技
上海威派格智慧水务股份有限公司	威派格
西安国际医学投资股份有限公司	国际医学
森赫电梯股份有限公司	森赫股份
河南太龙药业股份有限公司	太龙药业
江苏大港股份有限公司	大港股份
中际旭创股份有限公司	中际旭创
浙江尤夫高新纤维股份有限公司	尤夫股份
纽威数控装备苏州股份有限公司	纽威数控
德马科技集团股份有限公司	德马科技
绿地控股集团股份有限公司	绿地控股
华新水泥股份有限公司	华新水泥
青岛天能重工股份有限公司	天能重工
安徽巨一科技股份有限公司	巨一科技
上海临港控股股份有限公司	上海临港
九牧王股份有限公司	九牧王
北京安达维尔科技股份有限公司	安达维尔
江苏联环药业股份有限公司	联环药业
新亚电子股份有限公司	新亚电子
浙江双飞无油轴承股份有限公司	双飞股份
哈焊所华通常州焊业股份有限公司	哈焊华通
上海申通地铁股份有限公司	申通地铁
南方黑芝麻集团股份有限公司	黑芝麻
南京聚隆科技股份有限公司	南京聚隆
锋尚文化集团股份有限公司	锋尚文化
深圳市索菱实业股份有限公司	索菱股份
万向钱潮股份公司	万向钱潮
北京数字政通科技股份有限公司	数字政通
西上海汽车服务股份有限公司	西上海
金陵药业股份有限公司	金陵药业
英诺激光科技股份有限公司	英诺激光
贵州航宇科技发展股份有限公司	航宇科技
山东弘宇农机股份有限公司	弘宇股份
惠达卫浴股份有限公司	惠达卫浴
海信家电集团股份有限公司	海信家电
河南豫光金铅股份有限公司	豫光金铅
上海谊众药业股份有限公司	上海谊众
上海汇通能源股份有限公司	汇通能源
成都华神科技集团股份有限公司	华神科技
湖北均瑶大健康饮品股份有限公司	均瑶健康
甘肃荣华实业集团股份有限公司	荣华实业
北京高盟新材料股份有限公司	高盟新材
上海纳尔实业股份有限公司	纳尔股份
金财互联控股股份有限公司	金财互联
苏州新锐合金工具股份有限公司	新锐股份
通威股份有限公司	通威股份
河南瑞贝卡发制品股份有限公司	瑞贝卡
上海汉得信息技术股份有限公司	汉得信息
中饮巴比食品股份有限公司	巴比食品
三丰智能装备集团股份有限公司	三丰智能
山东鲁抗医药股份有限公司	鲁抗医药
上海百润投资控股集团股份有限公司	百润股份
阳普医疗科技股份有限公司	阳普医疗
广东依顿电子科技股份有限公司	依顿电子
南京健友生化制药股份有限公司	健友股份
吉林省金冠电气股份有限公司	金冠股份
陕西宝光真空电器股份有限公司	宝光股份
昆山沪光汽车电器股份有限公司	沪光股份
江苏万林现代物流股份有限公司	万林物流
新疆洪通燃气股份有限公司	洪通燃气
罗牛山股份有限公司	罗牛山
深圳市兆威机电股份有限公司	兆威机电
东北电气发展股份有限公司	东北电气
广博集团股份有限公司	广博股份
四川英杰电气股份有限公司	英杰电气
天阳宏业科技股份有限公司	天阳科技
南京科远智慧科技集团股份有限公司	科远智慧
四川海特高新技术股份有限公司	海特高新
合肥常青机械股份有限公司	常青股份
合肥百货大楼集团股份有限公司	合肥百货
熊猫乳品集团股份有限公司	熊猫乳品
深南金科股份有限公司	深南股份
长江医药控股股份有限公司	长药控股
惠州硕贝德无线科技股份有限公司	硕贝德
东阿阿胶股份有限公司	东阿阿胶
天津力生制药股份有限公司	力生制药
东莞捷荣技术股份有限公司	捷荣技术
佳沃食品股份有限公司	佳沃食品
辅仁药业集团制药股份有限公司	辅仁药业
中山华利实业集团股份有限公司	华利集团
山西蓝焰控股股份有限公司	蓝焰控股
成都爱乐达航空制造股份有限公司	爱乐达
重庆燃气集团股份有限公司	重庆燃气
中国黄金集团黄金珠宝股份有限公司	中国黄金
厦门信达股份有限公司	厦门信达
南京高科股份有限公司	南京高科
上海中洲特种合金材料股份有限公司	中洲特材
长春吉大正元信息技术股份有限公司	吉大正元
仁和药业股份有限公司	仁和药业
国脉科技股份有限公司	国脉科技
常熟市天银机电股份有限公司	天银机电
中国中铁股份有限公司	中国中铁
江苏丽岛新材料股份有限公司	丽岛新材
浙江朗迪集团股份有限公司	朗迪集团
山东朗进科技股份有限公司	朗进科技
上海尤安建筑设计股份有限公司	尤安设计
虹软科技股份有限公司	虹软科技
深圳市盐田港股份有限公司	盐田港
浙江正泰电器股份有限公司	正泰电器
长春奥普光电技术股份有限公司	奥普光电
浙江美力科技股份有限公司	美力科技
中节能国祯环保科技股份有限公司	节能国祯
中国医药健康产业股份有限公司	中国医药
安源煤业集团股份有限公司	安源煤业
传化智联股份有限公司	传化智联
天舟文化股份有限公司	天舟文化
广东天亿马信息产业股份有限公司	天亿马
上海宏达新材料股份有限公司	宏达新材
杭州高新橡塑材料股份有限公司	杭州高新
四川安宁铁钛股份有限公司	安宁股份
能科科技股份有限公司	能科科技
深圳市科陆电子科技股份有限公司	科陆电子
深圳市南极光电子科技股份有限公司	南极光
北京华胜天成科技股份有限公司	华胜天成
深圳市博硕科技股份有限公司	博硕科技
浙江京华激光科技股份有限公司	京华激光
津药药业股份有限公司	津药药业
江苏舜天股份有限公司	江苏舜天
宁波卡倍亿电气技术股份有限公司	卡倍亿
深圳市深粮控股股份有限公司	深粮控股
中原证券股份有限公司	中原证券
青岛康普顿科技股份有限公司	康普顿
广东松炀再生资源股份有限公司	松炀资源
中闽能源股份有限公司	中闽能源
成都振芯科技股份有限公司	振芯科技
吉林省集安益盛药业股份有限公司	益盛药业
北京威卡威汽车零部件股份有限公司	京威股份
深圳市英维克科技股份有限公司	英维克
嘉凯城集团股份有限公司	嘉凯城
杭州市园林绿化股份有限公司	园林股份
宝胜科技创新股份有限公司	宝胜股份
广东翔鹭钨业股份有限公司	翔鹭钨业
招商局能源运输股份有限公司	招商轮船
江苏安靠智能输电工程科技股份有限公司	安靠智电
卓郎智能技术股份有限公司	卓郎智能
重庆三峡水利电力集团股份有限公司	三峡水利
海南椰岛集团股份有限公司	海南椰岛
江西奇信集团股份有限公司	奇信股份
江苏吴中医药发展股份有限公司	江苏吴中
徐工集团工程机械股份有限公司	徐工机械
深圳市建艺装饰集团股份有限公司	建艺集团
烟台双塔食品股份有限公司	双塔食品
江苏农华智慧农业科技股份有限公司	智慧农业
深圳市迪威迅股份有限公司	迪威迅
上海行动教育科技股份有限公司	行动教育
上海航天汽车机电股份有限公司	航天机电
华测检测认证集团股份有限公司	华测检测
上海之江生物科技股份有限公司	之江生物
陕西金叶科教集团股份有限公司	陕西金叶
华丽家族股份有限公司	华丽家族
北京电子城高科技集团股份有限公司	电子城
苏州海陆重工股份有限公司	海陆重工
北京首旅酒店集团股份有限公司	首旅酒店
宁波震裕科技股份有限公司	震裕科技
上海北特科技股份有限公司	北特科技
绿景控股股份有限公司	绿景控股
易见供应链管理股份有限公司	易见股份
江苏今世缘酒业股份有限公司	今世缘
北京长久物流股份有限公司	长久物流
广州汽车集团股份有限公司	广汽集团
珠海安联锐视科技股份有限公司	安联锐视
上海雅运纺织化工股份有限公司	雅运股份
博深股份有限公司	博深股份
厦门万里石股份有限公司	万里石
广州鹏辉能源科技股份有限公司	鹏辉能源
深圳市汇川技术股份有限公司	汇川技术
力合科技湖南股份有限公司	力合科技
黄山永新股份有限公司	永新股份
新疆赛里木现代农业股份有限公司	新赛股份
二六三网络通信股份有限公司	二六三
大悦城控股集团股份有限公司	大悦城
新海宜科技集团股份有限公司	新海宜
河南恒星科技股份有限公司	恒星科技
航天通信控股集团股份有限公司	航天通信
长春燃气股份有限公司	长春燃气
中福海峡平潭发展股份有限公司	平潭发展
侨银城市管理股份有限公司	侨银股份
深圳市建筑科学研究院股份有限公司	建科院
四川新金路集团股份有限公司	新金路
斯太尔动力股份有限公司	斯太退
华东医药股份有限公司	华东医药
广东新宏泽包装股份有限公司	新宏泽
广西广播电视信息网络股份有限公司	广西广电
重庆正川医药包装材料股份有限公司	正川股份
浙江西大门新材料股份有限公司	西大门
联泓新材料科技股份有限公司	联泓新科
陕西建设机械股份有限公司	建设机械
南京诺唯赞生物科技股份有限公司	诺唯赞
幸福蓝海影视文化集团股份有限公司	幸福蓝海
兰州佛慈制药股份有限公司	佛慈制药
武汉长江通信产业集团股份有限公司	长江通信
苏州中来光伏新材股份有限公司	中来股份
金堆城钼业股份有限公司	金钼股份
凯撒中国文化股份有限公司	凯撒文化
上海派能能源科技股份有限公司	派能科技
东莞怡合达自动化股份有限公司	怡合达
海洋石油工程股份有限公司	海油工程
众望布艺股份有限公司	众望布艺
兰州兰石重型装备股份有限公司	兰石重装
上海世茂股份有限公司	世茂股份
扬州亚星客车股份有限公司	亚星客车
长缆电工科技股份有限公司	长缆科技
北方华创科技集团股份有限公司	北方华创
四川福蓉科技股份公司	福蓉科技
长春欧亚集团股份有限公司	欧亚集团
美好置业集团股份有限公司	美好置业
中国科技出版传媒股份有限公司	中国科传
宁波德业科技股份有限公司	德业股份
西藏珠峰资源股份有限公司	西藏珠峰
山东航空股份有限公司	山东航空
视觉中国文化发展股份有限公司	视觉中国
南京普天通信股份有限公司	南京普天
洽洽食品股份有限公司	洽洽食品
喜临门家具股份有限公司	喜临门
深圳海联讯科技股份有限公司	海联讯
南兴装备股份有限公司	南兴股份
上海三毛企业集团股份有限公司	上海三毛
青岛森麒麟轮胎股份有限公司	森麒麟
浙江双箭橡胶股份有限公司	双箭股份
江苏武进不锈股份有限公司	武进不锈
浙江万丰奥威汽轮股份有限公司	万丰奥威
华宝香精股份有限公司	华宝股份
北京八亿时空液晶科技股份有限公司	八亿时空
重庆川仪自动化股份有限公司	川仪股份
广东潮宏基实业股份有限公司	潮宏基
金发科技股份有限公司	金发科技
杭州新坐标科技股份有限公司	新坐标
无锡宝通科技股份有限公司	宝通科技
新经典文化股份有限公司	新经典
博济医药科技股份有限公司	博济医药
苏州绿的谐波传动科技股份有限公司	绿的谐波
保力新能源科技股份有限公司	保力新
深圳市容大感光科技股份有限公司	容大感光
天顺风能苏州股份有限公司	天顺风能
安徽丰原药业股份有限公司	丰原药业
厦门国贸集团股份有限公司	厦门国贸
联创电子科技股份有限公司	联创电子
江苏共创人造草坪股份有限公司	共创草坪
上海会畅通讯股份有限公司	会畅通讯
广州中海达卫星导航技术股份有限公司	中海达
岳阳兴长石化股份有限公司	岳阳兴长
北京京能电力股份有限公司	京能电力
昆山佰奥智能装备股份有限公司	佰奥智能
江苏龙蟠科技股份有限公司	龙蟠科技
四川汇源光通信股份有限公司	汇源通信
保利发展控股集团股份有限公司	保利发展
无锡和晶科技股份有限公司	和晶科技
江苏苏州农村商业银行股份有限公司	苏农银行
塞力斯医疗科技集团股份有限公司	塞力医疗
江苏中南建设集团股份有限公司	中南建设
华西证券股份有限公司	华西证券
浙江德宏汽车电子电器股份有限公司	德宏股份
安徽全柴动力股份有限公司	全柴动力
武汉帝尔激光科技股份有限公司	帝尔激光
苏州天孚光通信股份有限公司	天孚通信
哈尔滨博实自动化股份有限公司	博实股份
海南海德资本管理股份有限公司	海德股份
上海大众公用事业集团股份有限公司	大众公用
濮阳惠成电子材料股份有限公司	濮阳惠成
贵州钢绳股份有限公司	贵绳股份
盛新锂能集团股份有限公司	盛新锂能
华平信息技术股份有限公司	华平股份
深圳康泰生物制品股份有限公司	康泰生物
北京博睿宏远数据科技股份有限公司	博睿数据
豪尔赛科技集团股份有限公司	豪尔赛
无锡线上线下通讯信息技术股份有限公司	线上线下
海思科医药集团股份有限公司	海思科
成都唐源电气股份有限公司	唐源电气
光力科技股份有限公司	光力科技
紫金矿业集团股份有限公司	紫金矿业
天津中绿电投资股份有限公司	广宇发展
江西志特新材料股份有限公司	志特新材
南京雷尔伟新技术股份有限公司	雷尔伟
深圳市兆驰股份有限公司	兆驰股份
山东华鲁恒升化工股份有限公司	华鲁恒升
深圳市德方纳米科技股份有限公司	德方纳米
凯莱英医药集团天津股份有限公司	凯莱英
无锡威唐工业技术股份有限公司	威唐工业
北京科锐配电自动化股份有限公司	北京科锐
新洋丰农业科技股份有限公司	新洋丰
海南矿业股份有限公司	海南矿业
山东益生种畜禽股份有限公司	益生股份
中创物流股份有限公司	中创物流
四川科新机电股份有限公司	科新机电
协创数据技术股份有限公司	协创数据
三棵树涂料股份有限公司	三棵树
天水华天科技股份有限公司	华天科技
上海璞泰来新能源科技股份有限公司	璞泰来
北京顺鑫农业股份有限公司	顺鑫农业
浙江美大实业股份有限公司	浙江美大
内蒙古新华发行集团股份有限公司	内蒙新华
国家能源集团长源电力股份有限公司	长源电力
远信工业股份有限公司	远信工业
深圳市东方嘉盛供应链股份有限公司	东方嘉盛
吉林高速公路股份有限公司	吉林高速
山东宝莫生物化工股份有限公司	宝莫股份
四川新闻网传媒集团股份有限公司	川网传媒
交控科技股份有限公司	交控科技
中路股份有限公司	中路股份
昆山龙腾光电股份有限公司	龙腾光电
四川宏达股份有限公司	宏达股份
深圳市尚荣医疗股份有限公司	尚荣医疗
雅戈尔集团股份有限公司	雅戈尔
广州市广百股份有限公司	广百股份
舒华体育股份有限公司	舒华体育
中国宝安集团股份有限公司	中国宝安
广东众生药业股份有限公司	众生药业
广东美联新材料股份有限公司	美联新材
浙江诚意药业股份有限公司	诚意药业
湖南投资集团股份有限公司	湖南投资
天际新能源科技股份有限公司	天际股份
江苏南方精工股份有限公司	南方精工
南宁化工股份有限公司	南化股份
浙江田中精机股份有限公司	田中精机
山东钢铁股份有限公司	山东钢铁
珠海全志科技股份有限公司	全志科技
上海移远通信技术股份有限公司	移远通信
青岛国林科技集团股份有限公司	国林科技
百合花集团股份有限公司	百合花
上海锦和商业经营管理股份有限公司	锦和商管
京沪高速铁路股份有限公司	京沪高铁
巨轮智能装备股份有限公司	巨轮智能
四川大西洋焊接材料股份有限公司	大西洋
浙江古越龙山绍兴酒股份有限公司	古越龙山
罗克佳华科技集团股份有限公司	佳华科技
南京银行股份有限公司	南京银行
浙江昂利康制药股份有限公司	昂利康
中国南方航空股份有限公司	南方航空
杭州沪宁电梯部件股份有限公司	沪宁股份
上海龙头集团股份有限公司	龙头股份
博爱新开源医疗科技集团股份有限公司	新开源
山西华阳新材料股份有限公司	华阳新材
国安达股份有限公司	国安达
苏州市味知香食品股份有限公司	味知香
乐歌人体工学科技股份有限公司	乐歌股份
重庆智飞生物制品股份有限公司	智飞生物
安徽龙磁科技股份有限公司	龙磁科技
广州迈普再生医学科技股份有限公司	迈普医学
深圳市漫步者科技股份有限公司	漫步者
奥园美谷科技股份有限公司	奥园美谷
北京腾信创新网络营销技术股份有限公司	腾信股份
北讯集团股份有限公司	北讯集团
西安中熔电气股份有限公司	中熔电气
江苏亚威机床股份有限公司	亚威股份
中远海运特种运输股份有限公司	中远海特
江苏同力日升机械股份有限公司	同力日升
成都国光电气股份有限公司	国光电气
北京数字认证股份有限公司	数字认证
上工申贝集团股份有限公司	上工申贝
实丰文化发展股份有限公司	实丰文化
国电南瑞科技股份有限公司	国电南瑞
蓝思科技股份有限公司	蓝思科技
北京同益中新材料科技股份有限公司	同益中
宜宾五粮液股份有限公司	五粮液
珀莱雅化妆品股份有限公司	珀莱雅
江苏传艺科技股份有限公司	传艺科技
吉林利源精制股份有限公司	利源精制
宁波戴维医疗器械股份有限公司	戴维医疗
仙鹤股份有限公司	仙鹤股份
甘肃上峰水泥股份有限公司	上峰水泥
吉林吉大通信设计院股份有限公司	吉大通信
广东日丰电缆股份有限公司	日丰股份
欧浦智网股份有限公司	欧浦智网
上海浦东发展银行股份有限公司	浦发银行
浙江新澳纺织股份有限公司	新澳股份
现代投资股份有限公司	现代投资
杭叉集团股份有限公司	杭叉集团
我爱我家控股集团股份有限公司	我爱我家
海南海峡航运股份有限公司	海峡股份
北京全时天地在线网络信息股份有限公司	天地在线
普洛药业股份有限公司	普洛药业
新余钢铁股份有限公司	新钢股份
浙江东方基因生物制品股份有限公司	东方生物
宜宾纸业股份有限公司	宜宾纸业
广西五洲交通股份有限公司	五洲交通
西安陕鼓动力股份有限公司	陕鼓动力
江西赣粤高速公路股份有限公司	赣粤高速
浙江寿仙谷医药股份有限公司	寿仙谷
云南能源投资股份有限公司	云南能投
深圳和而泰智能控制股份有限公司	和而泰
青岛百洋医药股份有限公司	百洋医药
北京北信源软件股份有限公司	北信源
安徽建工集团股份有限公司	安徽建工
甘肃工程咨询集团股份有限公司	甘咨询
聚辰半导体股份有限公司	聚辰股份
安徽广信农化股份有限公司	广信股份
广西河池化工股份有限公司	河化股份
山鹰国际控股股份公司	山鹰国际
长白山旅游股份有限公司	长白山
江西联创光电科技股份有限公司	联创光电
上海和辉光电股份有限公司	和辉光电
苏州电器科学研究院股份有限公司	电科院
甘李药业股份有限公司	甘李药业
深信服科技股份有限公司	深信服
海南高速公路股份有限公司	海南高速
安井食品集团股份有限公司	安井食品
新疆天山畜牧生物工程股份有限公司	天山生物
安徽皖维高新材料股份有限公司	皖维高新
山东联诚精密制造股份有限公司	联诚精密
上海起帆电缆股份有限公司	起帆电缆
中电环保股份有限公司	中电环保
威海百合生物技术股份有限公司	百合股份
晋能控股山西煤业股份有限公司	晋控煤业
四川泸天化股份有限公司	泸天化
融捷股份有限公司	融捷股份
利欧集团股份有限公司	利欧股份
四川华体照明科技股份有限公司	华体科技
中远海运科技股份有限公司	中远海科
深圳市赢合科技股份有限公司	赢合科技
武汉锐科光纤激光技术股份有限公司	锐科激光
鸿博股份有限公司	鸿博股份
福建实达集团股份有限公司	实达集团
山东天岳先进科技股份有限公司	天岳先进
福建元力活性炭股份有限公司	元力股份
深圳市物业发展集团股份有限公司	深物业集团
大唐电信科技股份有限公司	大唐电信
江西海源复合材料科技股份有限公司	海源复材
火星人厨具股份有限公司	火星人
瓦房店轴承股份有限公司	瓦轴股份
亿晶光电科技股份有限公司	亿晶光电
北京三夫户外用品股份有限公司	三夫户外
浙江万安科技股份有限公司	万安科技
通用电梯股份有限公司	通用电梯
杭州安恒信息技术股份有限公司	安恒信息
广西柳工机械股份有限公司	柳工
大族激光科技产业集团股份有限公司	大族激光
宁波合力科技股份有限公司	合力科技
星辉环保材料股份有限公司	星辉环材
湖南南新制药股份有限公司	南新制药
安徽迎驾贡酒股份有限公司	迎驾贡酒
彩虹显示器件股份有限公司	彩虹股份
国网英大股份有限公司	国网英大
新疆友好集团股份有限公司	友好集团
新疆准东石油技术股份有限公司	准油股份
上海外服控股集团股份有限公司	外服控股
深圳歌力思服饰股份有限公司	歌力思
南京万德斯环保科技股份有限公司	万德斯
通化葡萄酒股份有限公司	通葡股份
苏州上声电子股份有限公司	上声电子
张家港中环海陆高端装备股份有限公司	中环海陆
浙江仁智股份有限公司	仁智股份
成都硅宝科技股份有限公司	硅宝科技
深圳通业科技股份有限公司	通业科技
君禾泵业股份有限公司	君禾股份
中公高科养护科技股份有限公司	中公高科
金河生物科技股份有限公司	金河生物
千禾味业食品股份有限公司	千禾味业
浙江正裕工业股份有限公司	正裕工业
君亭酒店集团股份有限公司	君亭酒店
江苏中超控股股份有限公司	中超控股
安徽山河药用辅料股份有限公司	山河药辅
陕西美邦药业集团股份有限公司	美邦股份
中金辐照股份有限公司	中金辐照
奥佳华智能健康科技集团股份有限公司	奥佳华
钢研纳克检测技术股份有限公司	钢研纳克
湖北凯龙化工集团股份有限公司	凯龙股份
浙江中晶科技股份有限公司	中晶科技
苏州瀚川智能科技股份有限公司	瀚川智能
沈阳惠天热电股份有限公司	惠天热电
亚信安全科技股份有限公司	亚信安全
南通江海电容器股份有限公司	江海股份
绝味食品股份有限公司	绝味食品
人福医药集团股份公司	人福医药
浙江松原汽车安全系统股份有限公司	松原股份
北京先进数通信息技术股份公司	先进数通
邦讯技术股份有限公司	邦讯技术
上海雪榕生物科技股份有限公司	雪榕生物
上海奕瑞光电子科技股份有限公司	奕瑞科技
浙江尖峰集团股份有限公司	尖峰集团
深圳市长亮科技股份有限公司	长亮科技
爱威科技股份有限公司	爱威科技
山西科新发展股份有限公司	科新发展
江西百胜智能科技股份有限公司	百胜智能
海南普利制药股份有限公司	普利制药
山东金城医药集团股份有限公司	金城医药
宁夏中科生物科技股份有限公司	宁科生物
杭州天地数码科技股份有限公司	天地数码
延安必康制药股份有限公司	延安必康
奥美医疗用品股份有限公司	奥美医疗
倍加洁集团股份有限公司	倍加洁
浙江伟明环保股份有限公司	伟明环保
东信和平科技股份有限公司	东信和平
汤臣倍健股份有限公司	汤臣倍健
珠海冠宇电池股份有限公司	珠海冠宇
江苏苏盐井神股份有限公司	苏盐井神
大连热电股份有限公司	大连热电
罗博特科智能科技股份有限公司	罗博特科
正源控股股份有限公司	正源股份
山西振东制药股份有限公司	振东制药
无锡新洁能股份有限公司	新洁能
张家港富瑞特种装备股份有限公司	富瑞特装
四创电子股份有限公司	四创电子
浙江步森服饰股份有限公司	步森股份
天娱数字科技大连集团股份有限公司	天娱数科
湘潭电机股份有限公司	湘电股份
宁德时代新能源科技股份有限公司	宁德时代
第一拖拉机股份有限公司	一拖股份
江阴市恒润重工股份有限公司	恒润股份
无锡华光环保能源集团股份有限公司	华光环能
兴业皮革科技股份有限公司	兴业科技
汉王科技股份有限公司	汉王科技
无锡贝斯特精机股份有限公司	贝斯特
青岛冠中生态股份有限公司	冠中生态
南方电网储能股份有限公司	南网储能
航锦科技股份有限公司	航锦科技
四川美丰化工股份有限公司	四川美丰
景津装备股份有限公司	景津装备
龙岩高岭土股份有限公司	龙高股份
浙江大丰实业股份有限公司	大丰实业
苏州锦富技术股份有限公司	锦富技术
贵州振华新材料股份有限公司	振华新材
安徽江南化工股份有限公司	江南化工
辽宁奥克化学股份有限公司	奥克股份
海南瑞泽新型建材股份有限公司	海南瑞泽
天津绿茵景观生态建设股份有限公司	绿茵生态
四川金时科技股份有限公司	金时科技
苏州禾盛新型材料股份有限公司	禾盛新材
瑞康医药集团股份有限公司	瑞康医药
武汉农尚环境股份有限公司	农尚环境
湖南军信环保股份有限公司	军信股份
大博医疗科技股份有限公司	大博医疗
悦康药业集团股份有限公司	悦康药业
苏州科达科技股份有限公司	苏州科达
吉林敖东药业集团股份有限公司	吉林敖东
浙江吉华集团股份有限公司	吉华集团
天茂实业集团股份有限公司	天茂集团
北京动力源科技股份有限公司	动力源
天风证券股份有限公司	天风证券
广东泰恩康医药股份有限公司	泰恩康
品茗科技股份有限公司	品茗科技
青木数字技术股份有限公司	青木股份
山东天鹅棉业机械股份有限公司	天鹅股份
杭州柯林电气股份有限公司	杭州柯林
上海荣泰健康科技股份有限公司	荣泰健康
中工国际工程股份有限公司	中工国际
南京熊猫电子股份有限公司	南京熊猫
广誉远中药股份有限公司	广誉远
淮北矿业控股股份有限公司	淮北矿业
新华联文化旅游发展股份有限公司	新华联
深圳市京泉华科技股份有限公司	京泉华
中科院成都信息技术股份有限公司	中科信息
沈阳机床股份有限公司	沈阳机床
南京化纤股份有限公司	南京化纤
郑州华晶金刚石股份有限公司	豫金刚石
温氏食品集团股份有限公司	温氏股份
北方联合出版传媒集团股份有限公司	出版传媒
江苏泛亚微透科技股份有限公司	泛亚微透
苏州春秋电子科技股份有限公司	春秋电子
金科环境股份有限公司	金科环境
钱江水利开发股份有限公司	钱江水利
杭州联德精密机械股份有限公司	联德股份
内蒙古平庄能源股份有限公司	平庄能源
福建福昕软件开发股份有限公司	福昕软件
百川能源股份有限公司	百川能源
诺德新材料股份有限公司	诺德股份
深圳市鼎阳科技股份有限公司	鼎阳科技
福建省爱迪尔珠宝实业股份有限公司	爱迪尔
九州通医药集团股份有限公司	九州通
中辰电缆股份有限公司	中辰股份
爱尔眼科医院集团股份有限公司	爱尔眼科
浙江皇马科技股份有限公司	皇马科技
蓝帆医疗股份有限公司	蓝帆医疗
聆达集团股份有限公司	聆达股份
山西路桥股份有限公司	山西路桥
法狮龙家居建材股份有限公司	法狮龙
马鞍山钢铁股份有限公司	马钢股份
西藏旅游股份有限公司	西藏旅游
獐子岛集团股份有限公司	獐子岛
广东宏川智慧物流股份有限公司	宏川智慧
山东海化股份有限公司	山东海化
华灿光电股份有限公司	华灿光电
深圳市怡亚通供应链股份有限公司	怡亚通
兆讯传媒广告股份有限公司	兆讯传媒
盛和资源控股股份有限公司	盛和资源
山高环能集团股份有限公司	山高环能
江苏云意电气股份有限公司	云意电气
上海凯鑫分离技术股份有限公司	上海凯鑫
上海亚虹模具股份有限公司	上海亚虹
株洲宏达电子股份有限公司	宏达电子
石家庄科林电气股份有限公司	科林电气
株洲华锐精密工具股份有限公司	华锐精密
石家庄通合电子科技股份有限公司	通合科技
远大产业控股股份有限公司	远大控股
厦门松霖科技股份有限公司	松霖科技
浙文互联集团股份有限公司	浙文互联
广东鸿图科技股份有限公司	广东鸿图
横店影视股份有限公司	横店影视
上海延华智能科技集团股份有限公司	延华智能
天津九安医疗电子股份有限公司	九安医疗
绍兴贝斯美化工股份有限公司	贝斯美
江苏宏图高科技股份有限公司	宏图高科
杭州钢铁股份有限公司	杭钢股份
浙江联盛化学股份有限公司	联盛化学
泰禾集团股份有限公司	泰禾集团
东方电气股份有限公司	东方电气
江苏太平洋石英股份有限公司	石英股份
哈药集团股份有限公司	哈药股份
浙文影业集团股份有限公司	浙文影业
北京利德曼生化股份有限公司	利德曼
广州地铁设计研究院股份有限公司	地铁设计
内蒙古君正能源化工集团股份有限公司	君正集团
常州神力电机股份有限公司	神力股份
四川汇宇制药股份有限公司	汇宇制药
凯撒同盛发展股份有限公司	凯撒旅业
广东星徽精密制造股份有限公司	星徽股份
河北建投能源投资股份有限公司	建投能源
武汉科前生物股份有限公司	科前生物
安徽集友新材料股份有限公司	集友股份
航天晨光股份有限公司	航天晨光
杭州百诚医药科技股份有限公司	百诚医药
极米科技股份有限公司	极米科技
上海海欣集团股份有限公司	海欣股份
成都市贝瑞和康基因技术股份有限公司	贝瑞基因
昆山新莱洁净应用材料股份有限公司	新莱应材
宁夏嘉泽新能源股份有限公司	嘉泽新能
南京中央商场集团股份有限公司	中央商场
北京诚益通控制工程科技股份有限公司	诚益通
广东道氏技术股份有限公司	道氏技术
中国重汽集团济南卡车股份有限公司	中国重汽
宁波三星医疗电气股份有限公司	三星医疗
江苏哈工智能机器人股份有限公司	哈工智能
上海复洁环保科技股份有限公司	复洁环保
中国铝业股份有限公司	中国铝业
广东顺威精密塑料股份有限公司	顺威股份
上海鸣志电器股份有限公司	鸣志电器
凯龙高科技股份有限公司	凯龙高科
东莞勤上光电股份有限公司	勤上股份
仙乐健康科技股份有限公司	仙乐健康
广东佳兆业佳云科技股份有限公司	佳云科技
华安鑫创控股北京股份有限公司	华安鑫创
福建创识科技股份有限公司	创识科技
德华兔宝宝装饰新材股份有限公司	兔宝宝
安徽超越环保科技股份有限公司	超越科技
哈尔滨威帝电子股份有限公司	威帝股份
潜能恒信能源技术股份有限公司	潜能恒信
神州数码信息服务股份有限公司	神州信息
狮头科技发展股份有限公司	狮头股份
中核苏阀科技实业股份有限公司	中核科技
辽宁港口股份有限公司	辽港股份
上海宝钢包装股份有限公司	宝钢包装
安琪酵母股份有限公司	安琪酵母
浙江三星新材股份有限公司	三星新材
中国航发动力控制股份有限公司	航发控制
深圳文科园林股份有限公司	文科园林
安徽口子酒业股份有限公司	口子窖
深圳中华自行车集团股份有限公司	深中华
三一重工股份有限公司	三一重工
甘肃蓝科石化高新装备股份有限公司	蓝科高新
北京三联虹普新合纤技术服务股份有限公司	三联虹普
软控股份有限公司	软控股份
广州港股份有限公司	广州港
柳州化工股份有限公司	柳化股份
山东华特达因健康股份有限公司	华特达因
厦门金达威集团股份有限公司	金达威
辽宁曙光汽车集团股份有限公司	曙光股份
广东三和管桩股份有限公司	三和管桩
新晨科技股份有限公司	新晨科技
苏州和林微纳科技股份有限公司	和林微纳
杭州和顺科技股份有限公司	和顺科技
元成环境股份有限公司	元成股份
浙江一鸣食品股份有限公司	一鸣食品
前沿生物药业南京股份有限公司	前沿生物
无锡江南奕帆电力传动科技股份有限公司	江南奕帆
固德威技术股份有限公司	固德威
江苏必得科技股份有限公司	必得科技
太龙电子股份有限公司	太龙股份
大连百傲化学股份有限公司	百傲化学
四川长虹电器股份有限公司	四川长虹
大禹节水集团股份有限公司	大禹节水
兴民智通集团股份有限公司	兴民智通
无锡智能自控工程股份有限公司	智能自控
上海外高桥集团股份有限公司	外高桥
西安饮食股份有限公司	西安饮食
常州千红生化制药股份有限公司	千红制药
财通证券股份有限公司	财通证券
西安蓝晓科技新材料股份有限公司	蓝晓科技
南京我乐家居股份有限公司	我乐家居
厦门合兴包装印刷股份有限公司	合兴包装
舍得酒业股份有限公司	舍得酒业
创维数字股份有限公司	创维数字
绿色动力环保集团股份有限公司	绿色动力
武汉菱电汽车电控系统股份有限公司	菱电电控
浙江天宇药业股份有限公司	天宇股份
成都圣诺生物科技股份有限公司	圣诺生物
苏州天华新能源科技股份有限公司	天华新能
深圳市特力集团股份有限公司	深特力
江苏五洋停车产业集团股份有限公司	五洋停车
河南省交通规划设计研究院股份有限公司	设研院
成都智明达电子股份有限公司	智明达
天津港股份有限公司	天津港
江苏泰慕士针纺科技股份有限公司	泰慕士
浙江迎丰科技股份有限公司	迎丰股份
昆仑万维科技股份有限公司	昆仑万维
安科瑞电气股份有限公司	安科瑞
株洲旗滨集团股份有限公司	旗滨集团
舒泰神北京生物制药股份有限公司	舒泰神
美克国际家居用品股份有限公司	美克家居
全通教育集团广东股份有限公司	全通教育
许昌开普检测研究院股份有限公司	开普检测
惠而浦中国股份有限公司	惠而浦
山东金晶科技股份有限公司	金晶科技
新大正物业集团股份有限公司	新大正
云南铜业股份有限公司	云南铜业
浙江镇洋发展股份有限公司	镇洋发展
广东天龙科技集团股份有限公司	天龙集团
广州视源电子科技股份有限公司	视源股份
黑牡丹集团股份有限公司	黑牡丹
深圳市禾望电气股份有限公司	禾望电气
福建博思软件股份有限公司	博思软件
东方财富信息股份有限公司	东方财富
广州天赐高新材料股份有限公司	天赐材料
深圳市兆新能源股份有限公司	兆新股份
天广中茂股份有限公司	天广中茂
格科微有限公司	格科微
四川富临运业集团股份有限公司	富临运业
广州广电运通金融电子股份有限公司	广电运通
广东松发陶瓷股份有限公司	松发股份
协鑫集成科技股份有限公司	协鑫集成
麦趣尔集团股份有限公司	麦趣尔
美的集团股份有限公司	美的集团
张家港广大特材股份有限公司	广大特材
杭州格林达电子材料股份有限公司	格林达
天虹数科商业股份有限公司	天虹股份
内蒙古伊泰煤炭股份有限公司	伊煤股份
杭州迪普科技股份有限公司	迪普科技
海峡创新互联网股份有限公司	海峡创新
浙江金鹰股份有限公司	金鹰股份
海航投资集团股份有限公司	海航投资
德邦物流股份有限公司	德邦股份
网宿科技股份有限公司	网宿科技
江苏苏利精细化工股份有限公司	苏利股份
天津捷强动力装备股份有限公司	捷强装备
广州越秀资本控股集团股份有限公司	越秀资本
杭州当虹科技股份有限公司	当虹科技
上海新朋实业股份有限公司	新朋股份
深圳顺络电子股份有限公司	顺络电子
深圳市京基智农时代股份有限公司	京基智农
远程电缆股份有限公司	远程股份
华润化学材料科技股份有限公司	华润材料
杨凌美畅新材料股份有限公司	美畅股份
上海普利特复合材料股份有限公司	普利特
浙江莎普爱思药业股份有限公司	莎普爱思
天津海泰科技发展股份有限公司	海泰发展
武汉华中数控股份有限公司	华中数控
安徽海螺水泥股份有限公司	海螺水泥
浙江金盾风机股份有限公司	金盾股份
山东金泰集团股份有限公司	山东金泰
广东朝阳电子科技股份有限公司	朝阳科技
陕西烽火电子股份有限公司	烽火电子
苏州纽威阀门股份有限公司	纽威股份
南京威尔药业集团股份有限公司	威尔药业
河南中原高速公路股份有限公司	中原高速
新大洲控股股份有限公司	新大洲控股
山煤国际能源集团股份有限公司	山煤国际
深圳南山热电股份有限公司	深南电
华创阳安股份有限公司	华创阳安
北京星网宇达科技股份有限公司	星网宇达
柳州两面针股份有限公司	两面针
成都盟升电子技术股份有限公司	盟升电子
河南仕佳光子科技股份有限公司	仕佳光子
杭州华星创业通信技术股份有限公司	华星创业
西安旅游股份有限公司	西安旅游
中科云网科技集团股份有限公司	中科云网
安徽皖通高速公路股份有限公司	皖通高速
上海能辉科技股份有限公司	能辉科技
北京赛科希德科技股份有限公司	赛科希德
甘肃省敦煌种业集团股份有限公司	敦煌种业
河南豫能控股股份有限公司	豫能控股
惠州亿纬锂能股份有限公司	亿纬锂能
中航工业产融控股股份有限公司	中航产融
商赢环球股份有限公司	商赢环球
大晟时代文化投资股份有限公司	大晟文化
广东莱尔新材料科技股份有限公司	莱尔科技
城发环境股份有限公司	城发环境
东沣科技集团股份有限公司	东沣B
九芝堂股份有限公司	九芝堂
康龙化成北京新药技术股份有限公司	康龙化成
安徽蓝盾光电子股份有限公司	蓝盾光电
北方化学工业股份有限公司	北化股份
西藏天路股份有限公司	西藏天路
鞍山七彩化学股份有限公司	七彩化学
北京映翰通网络技术股份有限公司	映翰通
申科滑动轴承股份有限公司	申科股份
武汉金运激光股份有限公司	金运激光
山西美锦能源股份有限公司	美锦能源
浙江帅丰电器股份有限公司	帅丰电器
中矿资源集团股份有限公司	中矿资源
特一药业集团股份有限公司	特一药业
浙江大东南股份有限公司	大东南
中农立华生物科技股份有限公司	中农立华
天圣制药集团股份有限公司	天圣制药
上海中谷物流股份有限公司	中谷物流
罗莱生活科技股份有限公司	罗莱生活
山东墨龙石油机械股份有限公司	山东墨龙
华电重工股份有限公司	华电重工
首航高科能源技术股份有限公司	首航高科
烟台中宠食品股份有限公司	中宠股份
卫宁健康科技集团股份有限公司	卫宁健康
贵州茅台酒股份有限公司	贵州茅台
三诺生物传感股份有限公司	三诺生物
晋亿实业股份有限公司	晋亿实业
成都利君实业股份有限公司	利君股份
上海康德莱企业发展集团股份有限公司	康德莱
杭州光云科技股份有限公司	光云科技
江西铜业股份有限公司	江西铜业
TCL科技集团股份有限公司	TCL科技
上海华谊集团股份有限公司	华谊集团
北方华锦化学工业股份有限公司	华锦股份
广州白云山医药集团股份有限公司	白云山
立讯精密工业股份有限公司	立讯精密
爱司凯科技股份有限公司	爱司凯
重庆渝开发股份有限公司	渝开发
广西东方智造科技股份有限公司	东方智造
西安曲江文化旅游股份有限公司	曲江文旅
华明电力装备股份有限公司	华明装备
通化金马药业集团股份有限公司	通化金马
浙江圣达生物药业股份有限公司	圣达生物
广东精艺金属股份有限公司	精艺股份
江西黑猫炭黑股份有限公司	黑猫股份
新东方新材料股份有限公司	东方材料
杭州爱科科技股份有限公司	爱科科技
森霸传感科技股份有限公司	森霸传感
安徽安科生物工程集团股份有限公司	安科生物
博瑞生物医药苏州股份有限公司	博瑞医药
上海凯利泰医疗科技股份有限公司	凯利泰
金石资源集团股份有限公司	金石资源
吉林紫鑫药业股份有限公司	紫鑫药业
广东富信科技股份有限公司	富信科技
上海唯赛勃环保科技股份有限公司	唯赛勃
天津百利特精电气股份有限公司	百利电气
浙江力诺流体控制科技股份有限公司	浙江力诺
珠海汇金科技股份有限公司	汇金科技
江西金力永磁科技股份有限公司	金力永磁
江苏恒辉安防股份有限公司	恒辉安防
金富科技股份有限公司	金富科技
京投发展股份有限公司	京投发展
陕西建工集团股份有限公司	陕西建工
苏州万祥科技股份有限公司	万祥科技
珈伟新能源股份有限公司	珈伟新能
财信地产发展集团股份有限公司	财信发展
湖南发展集团股份有限公司	湖南发展
铜陵洁雅生物科技股份有限公司	洁雅股份
新里程健康科技集团股份有限公司	新里程
北京中科金财科技股份有限公司	中科金财
北京东方园林环境股份有限公司	东方园林
光正眼科医院集团股份有限公司	光正眼科
中国长城科技集团股份有限公司	中国长城
四方科技集团股份有限公司	四方科技
浙江兆龙互连科技股份有限公司	兆龙互连
浙江海盐力源环保科技股份有限公司	力源科技
甘肃陇神戎发药业股份有限公司	陇神戎发
上海永茂泰汽车科技股份有限公司	永茂泰
北京莱伯泰科仪器股份有限公司	莱伯泰科
天地科技股份有限公司	天地科技
广汇能源股份有限公司	广汇能源
桂林福达股份有限公司	福达股份
深圳万讯自控股份有限公司	万讯自控
香飘飘食品股份有限公司	香飘飘
安徽艾可蓝环保股份有限公司	艾可蓝
日出东方控股股份有限公司	日出东方
江苏中利集团股份有限公司	中利集团
百洋产业投资集团股份有限公司	百洋股份
莲花健康产业集团股份有限公司	莲花健康
广东南方新媒体股份有限公司	新媒股份
中兵红箭股份有限公司	中兵红箭
湖南领湃达志科技股份有限公司	达志科技
河钢资源股份有限公司	河钢资源
深圳太辰光通信股份有限公司	太辰光
上海矩子科技股份有限公司	矩子科技
中钢国际工程技术股份有限公司	中钢国际
深圳市银之杰科技股份有限公司	银之杰
山西安泰集团股份有限公司	安泰集团
南京市测绘勘察研究院股份有限公司	测绘股份
杭州福莱蒽特股份有限公司	福莱蒽特
江苏赛福天钢索股份有限公司	赛福天
宁波联合集团股份有限公司	宁波联合
上海肇民新材料科技股份有限公司	肇民科技
北京亚康万玮信息技术股份有限公司	亚康股份
宁波方正汽车模具股份有限公司	宁波方正
晋能控股山西电力股份有限公司	晋控电力
湖南宇新能源科技股份有限公司	宇新股份
无锡农村商业银行股份有限公司	无锡银行
深圳市水务规划设计院股份有限公司	深水规院
西安派瑞功率半导体变流技术股份有限公司	派瑞股份
创耀苏州通信科技股份有限公司	创耀科技
无锡雪浪环境科技股份有限公司	雪浪环境
欣龙控股集团股份有限公司	欣龙控股
江苏振江新能源装备股份有限公司	振江股份
苏州国芯科技股份有限公司	国芯科技
上海电气风电集团股份有限公司	电气风电
宜宾天原集团股份有限公司	天原股份
北京赛微电子股份有限公司	赛微电子
中国石化上海石油化工股份有限公司	上海石化
新疆西部牧业股份有限公司	西部牧业
安徽鑫科新材料股份有限公司	鑫科材料
中石化石油机械股份有限公司	石化机械
常熟风范电力设备股份有限公司	风范股份
北京慧辰资道资讯股份有限公司	慧辰股份
横店集团得邦照明股份有限公司	得邦照明
汇通建设集团股份有限公司	汇通集团
天津泰达股份有限公司	泰达股份
吉视传媒股份有限公司	吉视传媒
广州安必平医药科技股份有限公司	安必平
上海爱旭新能源股份有限公司	爱旭股份
湖北久之洋红外系统股份有限公司	久之洋
廊坊发展股份有限公司	廊坊发展
广东奥马电器股份有限公司	奥马电器
华兰生物工程股份有限公司	华兰生物
上海市天宸股份有限公司	天宸股份
湖南新五丰股份有限公司	新五丰
深圳市宇顺电子股份有限公司	宇顺电子
辽宁能源煤电产业股份有限公司	辽宁能源
浙江真爱美家股份有限公司	真爱美家
南京越博动力系统股份有限公司	越博动力
江苏国泰国际集团股份有限公司	江苏国泰
新疆青松建材化工集团股份有限公司	青松建化
杭州炬华科技股份有限公司	炬华科技
厦门灿坤实业股份有限公司	闽灿坤
光大嘉宝股份有限公司	光大嘉宝
科兴生物制药股份有限公司	科兴制药
江阴电工合金股份有限公司	电工合金
云南城投置业股份有限公司	云南城投
上海环境集团股份有限公司	上海环境
深圳瑞华泰薄膜科技股份有限公司	瑞华泰
佳禾食品工业股份有限公司	佳禾食品
物产中大集团股份有限公司	物产中大
陕西中天火箭技术股份有限公司	中天火箭
老凤祥股份有限公司	老凤祥
广东粤海饲料集团股份有限公司	粤海饲料
居然之家新零售集团股份有限公司	居然之家
欧普康视科技股份有限公司	欧普康视
浙江医药股份有限公司	浙江医药
深圳科士达科技股份有限公司	科士达
贵州盘江精煤股份有限公司	盘江股份
凌云工业股份有限公司	凌云股份
东莞金太阳研磨股份有限公司	金太阳
江西洪城环境股份有限公司	洪城环境
龙岩卓越新能源股份有限公司	卓越新能
青岛高测科技股份有限公司	高测股份
四方光电股份有限公司	四方光电
宁波水表集团股份有限公司	宁水集团
中船科技股份有限公司	中船科技
同庆楼餐饮股份有限公司	同庆楼
亿利洁能股份有限公司	亿利洁能
宝鸡钛业股份有限公司	宝钛股份
成都豪能科技股份有限公司	豪能股份
江苏国信股份有限公司	江苏国信
中简科技股份有限公司	中简科技
罗欣药业集团股份有限公司	罗欣药业
吉林电力股份有限公司	吉电股份
北京三元食品股份有限公司	三元股份
中国外运股份有限公司	中国外运
宁波激智科技股份有限公司	激智科技
浙江鼎力机械股份有限公司	浙江鼎力
青岛酷特智能股份有限公司	酷特智能
湖北兴发化工集团股份有限公司	兴发集团
浙江万盛股份有限公司	万盛股份
天康生物股份有限公司	天康生物
高新兴科技集团股份有限公司	高新兴
北京华联商厦股份有限公司	华联股份
青海华鼎实业股份有限公司	青海华鼎
赛轮集团股份有限公司	赛轮轮胎
广东九联科技股份有限公司	九联科技
冠城大通股份有限公司	冠城大通
中船重工汉光科技股份有限公司	中船汉光
北京银信长远科技股份有限公司	银信科技
浙江我武生物科技股份有限公司	我武生物
震安科技股份有限公司	震安科技
安徽恒源煤电股份有限公司	恒源煤电
天合光能股份有限公司	天合光能
上海古鳌电子科技股份有限公司	古鳌科技
国元证券股份有限公司	国元证券
碳元科技股份有限公司	碳元科技
上海柏楚电子科技股份有限公司	柏楚电子
会稽山绍兴酒股份有限公司	会稽山
金通灵科技集团股份有限公司	金通灵
福建漳州发展股份有限公司	漳州发展
浙江金道科技股份有限公司	金道科技
北方导航控制技术股份有限公司	北方导航
深圳市广和通无线股份有限公司	广和通
潍柴动力股份有限公司	潍柴动力
瑞泰科技股份有限公司	瑞泰科技
奥瑞德光电股份有限公司	奥瑞德
金陵饭店股份有限公司	金陵饭店
北京天坛生物制品股份有限公司	天坛生物
宁波色母粒股份有限公司	宁波色母
鸿利智汇集团股份有限公司	鸿利智汇
浙江甬金金属科技股份有限公司	甬金股份
深圳科瑞技术股份有限公司	科瑞技术
长华控股集团股份有限公司	长华集团
华天酒店集团股份有限公司	华天酒店
江苏江南高纤股份有限公司	江南高纤
南京公用发展股份有限公司	南京公用
广东利扬芯片测试股份有限公司	利扬芯片
漳州片仔癀药业股份有限公司	片仔癀
北京金自天正智能控制股份有限公司	金自天正
云赛智联股份有限公司	云赛智联
中国电信股份有限公司	中国电信
深圳广田集团股份有限公司	广田集团
重庆路桥股份有限公司	重庆路桥
浙江红蜻蜓鞋业股份有限公司	红蜻蜓
南京华脉科技股份有限公司	华脉科技
盛达金属资源股份有限公司	盛达资源
金杯汽车股份有限公司	金杯汽车
拉卡拉支付股份有限公司	拉卡拉
中航重机股份有限公司	中航重机
青岛德固特节能装备股份有限公司	德固特
晶科能源股份有限公司	晶科能源
读者出版传媒股份有限公司	读者传媒
河北建新化工股份有限公司	建新股份
四川川环科技股份有限公司	川环科技
北京指南针科技发展股份有限公司	指南针
思进智能成形装备股份有限公司	思进智能
众业达电气股份有限公司	众业达
上海华鑫股份有限公司	华鑫股份
新希望六和股份有限公司	新希望
新乡拓新药业股份有限公司	拓新药业
广东中南钢铁股份有限公司	中南股份
北京鼎汉技术集团股份有限公司	鼎汉技术
陕西康惠制药股份有限公司	康惠制药
罗普特科技集团股份有限公司	罗普特
新疆天润乳业股份有限公司	天润乳业
中铝国际工程股份有限公司	中铝国际
苏州柯利达装饰股份有限公司	柯利达
江西天利科技股份有限公司	天利科技
北京义翘神州科技股份有限公司	义翘神州
巨力索具股份有限公司	巨力索具
新亚制程浙江股份有限公司	新亚制程
圆通速递股份有限公司	圆通速递
苏州市世嘉科技股份有限公司	世嘉科技
广东海大集团股份有限公司	海大集团
上海海得控制系统股份有限公司	海得控制
航天科技控股集团股份有限公司	航天科技
宁波旭升集团股份有限公司	旭升集团
江苏新美星包装机械股份有限公司	新美星
中贝通信集团股份有限公司	中贝通信
上海信联信息发展股份有限公司	信息发展
江西恒大高新技术股份有限公司	恒大高新
爱普香料集团股份有限公司	爱普股份
四川浪莎控股股份有限公司	浪莎股份
重庆长安汽车股份有限公司	长安汽车
上海智汇未来医疗服务股份有限公司	未来股份
大连豪森设备制造股份有限公司	豪森股份
湖南金博碳素股份有限公司	金博股份
西安宝德自动化股份有限公司	宝德股份
福建福日电子股份有限公司	福日电子
德艺文化创意集团股份有限公司	德艺文创
百济神州有限公司	百济神州
山东圣阳电源股份有限公司	圣阳股份
济民健康管理股份有限公司	济民医疗
北京燕京啤酒股份有限公司	燕京啤酒
江苏美思德化学股份有限公司	美思德
一品红药业股份有限公司	一品红
广州广日股份有限公司	广日股份
厦门亿联网络技术股份有限公司	亿联网络
中国巨石股份有限公司	中国巨石
常柴股份有限公司	苏常柴
深圳赛格股份有限公司	深赛格
江苏恒立液压股份有限公司	恒立液压
金埔园林股份有限公司	金埔园林
开元教育科技集团股份有限公司	开元教育
南京泉峰汽车精密技术股份有限公司	泉峰汽车
上海沿浦金属制品股份有限公司	上海沿浦
呈和科技股份有限公司	呈和科技
深圳华侨城股份有限公司	华侨城
山东赫达集团股份有限公司	山东赫达
三人行传媒集团股份有限公司	三人行
北京海兰信数据科技股份有限公司	海兰信
江苏海鸥冷却塔股份有限公司	海鸥股份
中科寒武纪科技股份有限公司	寒武纪
天津经纬辉开光电股份有限公司	经纬辉开
湖北能源集团股份有限公司	湖北能源
武汉天源环保股份有限公司	天源环保
上海隧道工程股份有限公司	隧道股份
杭州宏华数码科技股份有限公司	宏华数科
广州若羽臣科技股份有限公司	若羽臣
福建广生堂药业股份有限公司	广生堂
科达制造股份有限公司	科达制造
深圳市沃特新材料股份有限公司	沃特股份
广州市昊志机电股份有限公司	昊志机电
成都旭光电子股份有限公司	旭光电子
上海新华传媒股份有限公司	新华传媒
南京钢铁股份有限公司	南钢股份
新疆国际实业股份有限公司	国际实业
安徽省司尔特肥业股份有限公司	司尔特
沈阳远大智能工业集团股份有限公司	远大智能
杭州屹通新材料股份有限公司	屹通新材
杭州解百集团股份有限公司	杭州解百
中国石化山东泰山石油股份有限公司	泰山石油
沧州大化股份有限公司	沧州大化
艾格拉斯股份有限公司	艾格拉斯
成都天箭科技股份有限公司	天箭科技
杭氧集团股份有限公司	杭氧股份
深圳市皇庭国际企业股份有限公司	皇庭国际
博创科技股份有限公司	博创科技
首药控股北京股份有限公司	首药控股
江苏富淼科技股份有限公司	富淼科技
浙江苏泊尔股份有限公司	苏泊尔
广东新宝电器股份有限公司	新宝股份
深圳市深科达智能装备股份有限公司	深科达
完美世界股份有限公司	完美世界
山东瑞丰高分子材料股份有限公司	瑞丰高材
福建睿能科技股份有限公司	睿能科技
山子高科技股份有限公司	山子股份
株洲欧科亿数控精密刀具股份有限公司	欧科亿
陕西黑猫焦化股份有限公司	陕西黑猫
快意电梯股份有限公司	快意电梯
新疆机械研究院股份有限公司	新研股份
北京天宜上佳高新材料股份有限公司	天宜上佳
山东惠发食品股份有限公司	惠发食品
德展大健康股份有限公司	德展健康
确成硅化学股份有限公司	确成股份
菲林格尔家居科技股份有限公司	菲林格尔
北京钢研高纳科技股份有限公司	钢研高纳
罗顿发展股份有限公司	罗顿发展
上海银行股份有限公司	上海银行
浙江三花智能控制股份有限公司	三花智控
深圳市同洲电子股份有限公司	同洲电子
深圳科创新源新材料股份有限公司	科创新源
凤凰光学股份有限公司	凤凰光学
南京药石科技股份有限公司	药石科技
南方风机股份有限公司	南风股份
广西博世科环保科技股份有限公司	博世科
福建福晶科技股份有限公司	福晶科技
沈阳芯源微电子设备股份有限公司	芯源微
深圳金信诺高新技术股份有限公司	金信诺
港中旅华贸国际物流股份有限公司	华贸物流
弘元绿色能源股份有限公司	弘元绿能
森特士兴集团股份有限公司	森特股份
宁波东方电缆股份有限公司	东方电缆
中信重工机械股份有限公司	中信重工
东莞宜安科技股份有限公司	宜安科技
武汉凡谷电子技术股份有限公司	武汉凡谷
山东双一科技股份有限公司	双一科技
深圳市共进电子股份有限公司	共进股份
北京博晖创新生物技术集团股份有限公司	博晖创新
迈威上海生物科技股份有限公司	迈威生物
东莞发展控股股份有限公司	东莞控股
重庆万里新能源股份有限公司	万里股份
广州惠威电声科技股份有限公司	惠威科技
易事特集团股份有限公司	易事特
天能电池集团股份有限公司	天能股份
上海新炬网络信息技术股份有限公司	新炬网络
电连技术股份有限公司	电连技术
江苏卓胜微电子股份有限公司	卓胜微
沧州明珠塑料股份有限公司	沧州明珠
元翔厦门国际航空港股份有限公司	厦门空港
内蒙古蒙电华能热电股份有限公司	内蒙华电
昆药集团股份有限公司	昆药集团
内蒙古包钢钢联股份有限公司	包钢股份
爱柯迪股份有限公司	爱柯迪
光智科技股份有限公司	光智科技
张家港海锅新能源装备股份有限公司	海锅股份
鹭燕医药股份有限公司	鹭燕医药
开山集团股份有限公司	开山股份
福达合金材料股份有限公司	福达合金
青岛东软载波科技股份有限公司	东软载波
重庆梅安森科技股份有限公司	梅安森
宁波富佳实业股份有限公司	富佳股份
苏州东微半导体股份有限公司	东微半导
烟台北方安德利果汁股份有限公司	安德利
江苏骏成电子科技股份有限公司	骏成科技
江苏力星通用钢球股份有限公司	力星股份
科林环保装备股份有限公司	科林环保
安徽开润股份有限公司	开润股份
文峰大世界连锁发展股份有限公司	文峰股份
西安标准工业股份有限公司	标准股份
襄阳汽车轴承股份有限公司	襄阳轴承
国机精工股份有限公司	国机精工
四川九洲电器股份有限公司	四川九洲
广东小崧科技股份有限公司	小崧股份
山东新华锦国际股份有限公司	新华锦
宣亚国际营销科技北京股份有限公司	宣亚国际
安徽华塑股份有限公司	华塑股份
上海金桥出口加工区开发股份有限公司	浦东金桥
深圳华大基因股份有限公司	华大基因
宁波乐惠国际工程装备股份有限公司	乐惠国际
广州广哈通信股份有限公司	广哈通信
重庆啤酒股份有限公司	重庆啤酒
日播时尚集团股份有限公司	日播时尚
亚钾国际投资广州股份有限公司	亚钾国际
广联达科技股份有限公司	广联达
南京大学环境规划设计研究院集团股份公司	南大环境
中海油田服务股份有限公司	中海油服
今创集团股份有限公司	今创集团
气派科技股份有限公司	气派科技
山东仙坛股份有限公司	仙坛股份
上海沪工焊接集团股份有限公司	上海沪工
通裕重工股份有限公司	通裕重工
浙江雅艺金属科技股份有限公司	雅艺科技
劲仔食品集团股份有限公司	劲仔食品
广东格林精密部件股份有限公司	格林精密
安徽安纳达钛业股份有限公司	安纳达
湖南湘佳牧业股份有限公司	湘佳股份
兄弟科技股份有限公司	兄弟科技
上海澳华内镜股份有限公司	澳华内镜
江苏三六五网络股份有限公司	三六五网
北京阳光诺和药物研究股份有限公司	阳光诺和
深圳市卫光生物制品股份有限公司	卫光生物
深圳市沃尔核材股份有限公司	沃尔核材
国光电器股份有限公司	国光电器
大唐高鸿网络股份有限公司	高鸿股份
创元科技股份有限公司	创元科技
美康生物科技股份有限公司	美康生物
河北中瓷电子科技股份有限公司	中瓷电子
物产中大金轮蓝海股份有限公司	物产金轮
江西特种电机股份有限公司	江特电机
炬芯科技股份有限公司	炬芯科技
上海汇丽建材股份有限公司	汇丽股份
浙江物产环保能源股份有限公司	物产环能
厦门厦工机械股份有限公司	厦工股份
浙江出版传媒股份有限公司	浙版传媒
唐人神集团股份有限公司	唐人神
珠海恒基达鑫国际化工仓储股份有限公司	恒基达鑫
苏州春兴精工股份有限公司	春兴精工
北京首都在线科技股份有限公司	首都在线
展鹏科技股份有限公司	展鹏科技
江西赣锋锂业集团股份有限公司	赣锋锂业
丽江玉龙旅游股份有限公司	丽江股份
北京信威科技集团股份有限公司	信威集团
江苏润邦重工股份有限公司	润邦股份
北京佰仁医疗科技股份有限公司	佰仁医疗
杭州聚合顺新材料股份有限公司	聚合顺
四川天微电子股份有限公司	天微电子
珠海和佳医疗设备股份有限公司	和佳医疗
信质集团股份有限公司	信质集团
青海金瑞矿业发展股份有限公司	金瑞矿业
深圳市智莱科技股份有限公司	智莱科技
光启技术股份有限公司	光启技术
江苏永鼎股份有限公司	永鼎股份
杭州山科智能科技股份有限公司	山科智能
瑞茂通供应链管理股份有限公司	瑞茂通
招商局公路网络科技控股股份有限公司	招商公路
冠福控股股份有限公司	冠福股份
安徽皖仪科技股份有限公司	皖仪科技
中国葛洲坝集团股份有限公司	葛洲坝
启明信息技术股份有限公司	启明信息
浙江永和制冷股份有限公司	永和股份
浙江新光药业股份有限公司	新光药业
保龄宝生物股份有限公司	保龄宝
深圳市大为创新科技股份有限公司	大为股份
深圳中恒华发股份有限公司	深华发
贵州贵航汽车零部件股份有限公司	贵航股份
广州发展集团股份有限公司	广州发展
江苏本川智能电路科技股份有限公司	本川智能
日禾戎美股份有限公司	戎美股份
宁夏东方钽业股份有限公司	东方钽业
昆山东威科技股份有限公司	东威科技
大湖水殖股份有限公司	大湖股份
华懋厦门新材料科技股份有限公司	华懋科技
浙江方正电机股份有限公司	方正电机
中电科网络安全科技股份有限公司	电科网安
新疆天顺供应链股份有限公司	天顺股份
福建星云电子股份有限公司	星云股份
营口港务股份有限公司	营口港
维尔利环保科技集团股份有限公司	维尔利
首华燃气科技上海股份有限公司	首华燃气
深圳市易尚展示股份有限公司	易尚展示
浙江万胜智能科技股份有限公司	万胜智能
大金重工股份有限公司	大金重工
长江证券股份有限公司	长江证券
浙江亚太药业股份有限公司	亚太药业
新纶新材料股份有限公司	新纶新材
北京北纬通信科技股份有限公司	北纬科技
安徽大地熊新材料股份有限公司	大地熊
浙江长盛滑动轴承股份有限公司	长盛轴承
福然德股份有限公司	福然德
莱克电气股份有限公司	莱克电气
广东奥飞数据科技股份有限公司	奥飞数据
山东凯盛新材料股份有限公司	凯盛新材
云南铝业股份有限公司	云铝股份
上海泰胜风能装备股份有限公司	泰胜风能
龙源电力集团股份有限公司	龙源电力
广东原尚物流股份有限公司	原尚股份
北京中岩大地科技股份有限公司	中岩大地
天津七一二通信广播股份有限公司	七一二
江苏广信感光新材料股份有限公司	广信材料
广汇物流股份有限公司	广汇物流
无锡信捷电气股份有限公司	信捷电气
扬州扬杰电子科技股份有限公司	扬杰科技
中盐内蒙古化工股份有限公司	中盐化工
厦门吉宏科技股份有限公司	吉宏股份
北京康斯特仪表科技股份有限公司	康斯特
中国国检测试控股集团股份有限公司	国检集团
宝山钢铁股份有限公司	宝钢股份
抚顺特殊钢股份有限公司	抚顺特钢
鼎捷软件股份有限公司	鼎捷软件
国城矿业股份有限公司	国城矿业
湖南湘邮科技股份有限公司	湘邮科技
新凤鸣集团股份有限公司	新凤鸣
博迈科海洋工程股份有限公司	博迈科
融捷健康科技股份有限公司	融捷健康
中国石油化工股份有限公司	中国石化
国机重型装备集团股份有限公司	国机重装
成都苑东生物制药股份有限公司	苑东生物
扬州海昌新材股份有限公司	海昌新材
上海游久游戏股份有限公司	游久游戏
长春一汽富维汽车零部件股份有限公司	一汽富维
深圳市英威腾电气股份有限公司	英威腾
长春一东离合器股份有限公司	长春一东
上海宏力达信息技术股份有限公司	宏力达
神驰机电股份有限公司	神驰机电
东方电子股份有限公司	东方电子
昇辉智能科技股份有限公司	昇辉科技
河南清水源科技股份有限公司	清水源
中国国际航空股份有限公司	中国国航
帝欧家居集团股份有限公司	帝欧家居
福立旺精密机电中国股份有限公司	福立旺
上海锦江在线网络服务股份有限公司	锦江在线
浙江水晶光电科技股份有限公司	水晶光电
盛美半导体设备上海股份有限公司	盛美上海
志邦家居股份有限公司	志邦家居
深圳信隆健康产业发展股份有限公司	信隆健康
江苏凯伦建材股份有限公司	凯伦股份
上海泛微网络科技股份有限公司	泛微网络
百大集团股份有限公司	百大集团
江苏连云港港口股份有限公司	连云港
无锡帝科电子材料股份有限公司	帝科股份
上海金力泰化工股份有限公司	金力泰
东方明珠新媒体股份有限公司	东方明珠
青岛食品股份有限公司	青岛食品
湖北华强科技股份有限公司	华强科技
交通银行股份有限公司	交通银行
济南高新发展股份有限公司	济南高新
海控南海发展股份有限公司	海南发展
华能澜沧江水电股份有限公司	华能水电
宁夏晓鸣农牧股份有限公司	晓鸣股份
三川智慧科技股份有限公司	三川智慧
国药集团一致药业股份有限公司	国药一致
沈阳兴齐眼药股份有限公司	兴齐眼药
航天时代电子技术股份有限公司	航天电子
申万宏源集团股份有限公司	申万宏源
广州市金钟汽车零件股份有限公司	金钟股份
深圳华强实业股份有限公司	深圳华强
常州亚玛顿股份有限公司	亚玛顿
江苏扬农化工股份有限公司	扬农化工
仁东控股股份有限公司	仁东控股
南通江山农药化工股份有限公司	江山股份
